form	lemma	POS	morph
veult	voloir	VERcjg	MODE=ind|TEMPS=pst|PERS.=3|NOMB.=s
conter	conter	VERinf	MORPH=empty
rimoier	rimoiier1	VERinf	MORPH=empty
doit	devoir	VERcjg	MODE=ind|TEMPS=pst|PERS.=3|NOMB.=s
sen	sen2	NOMcom	NOMB.=s|GENRE=m|CAS=r
emploier	emploiier	VERinf	MORPH=empty
conter	conter	VERinf	MORPH=empty
mensonges	mençogne	NOMcom	NOMB.=p|GENRE=m|CAS=r
fables	fable	NOMcom	NOMB.=p|GENRE=f|CAS=r
est	estre1	VERcjg	MODE=ind|TEMPS=pst|PERS.=3|NOMB.=s
contes	conte2	NOMcom	NOMB.=s|GENRE=m|CAS=n
profitables	porfitable	ADJqua	NOMB.=s|GENRE=m|CAS=n|DEGRE=p
voire	voir	ADJqua	NOMB.=s|GENRE=f|CAS=r|DEGRE=p
estoire	estoire1	NOMcom	NOMB.=s|GENRE=f|CAS=r
treitier	traitier	VERinf	MORPH=empty
puet	pöoir	VERcjg	MODE=ind|TEMPS=pst|PERS.=3|NOMB.=s
valleir	valoir	VERinf	MORPH=empty
profitier	porfit(i)er	VERinf	MORPH=empty
doit	devoir	VERcjg	MODE=ind|TEMPS=pst|PERS.=3|NOMB.=s
mettre	metre2	VERinf	MORPH=empty
poine	peine	NOMcom	NOMB.=s|GENRE=f|CAS=r
cure	cure	NOMcom	NOMB.=s|GENRE=f|CAS=r
fet	faire	VERcjg	MODE=ind|TEMPS=pst|PERS.=3|NOMB.=s
lere	lire1	VERinf	MORPH=empty
voire	voir	ADJqua	NOMB.=s|GENRE=f|CAS=r|DEGRE=p
escripture	escriture	NOMcom	NOMB.=s|GENRE=f|CAS=r
doit	devoir	VERcjg	MODE=ind|TEMPS=pst|PERS.=3|NOMB.=s
estre	estre1	VERinf	MORPH=empty
chose	chose	NOMcom	NOMB.=s|GENRE=f|CAS=n
amembree	amembrer2	VERppe	NOMB.=s|GENRE=f|CAS=n
verité	verité	NOMcom	NOMB.=s|GENRE=f|CAS=r
est	estre1	VERcjg	MODE=ind|TEMPS=pst|PERS.=3|NOMB.=s
fondee	fonder2	VERppe	NOMB.=s|GENRE=f|CAS=n
voire	voir	ADJqua	NOMB.=s|GENRE=f|CAS=r|DEGRE=p
chouse	chose	NOMcom	NOMB.=s|GENRE=f|CAS=r
conter	conter	VERinf	MORPH=empty
puet	pöoir	VERcjg	MODE=ind|TEMPS=pst|PERS.=3|NOMB.=s
pris	pris1	NOMcom	NOMB.=s|GENRE=m|CAS=r
lous	los1	NOMcom	NOMB.=s|GENRE=m|CAS=r
monter	monter	VERinf	MORPH=empty
ai	avoir	VERcjg	MODE=ind|TEMPS=pst|PERS.=1|NOMB.=s
esleü	eslire	VERppe	NOMB.=s|GENRE=m|CAS=r
matire	matiere	NOMcom	NOMB.=s|GENRE=f|CAS=r
voill	voloir	VERcjg	MODE=ind|TEMPS=pst|PERS.=1|NOMB.=s
treitier	traitier	VERinf	MORPH=empty
escrire	escrire	VERinf	MORPH=empty
a	avoir	VERcjg	MODE=ind|TEMPS=pst|PERS.=3|NOMB.=s
verité	verité	NOMcom	NOMB.=s|GENRE=f|CAS=r
tesmoign	tesmoin	NOMcom	NOMB.=s|GENRE=m|CAS=r
antiquité	antiquité	NOMcom	NOMB.=s|GENRE=f|CAS=r
fist	faire	VERcjg	MODE=ind|TEMPS=psp|PERS.=3|NOMB.=s
latin	latin	NOMcom	NOMB.=s|GENRE=m|CAS=r
livre	livre2	NOMcom	NOMB.=s|GENRE=m|CAS=r
nuit	nuit	NOMcom	NOMB.=s|GENRE=f|CAS=r
iglise	eglise	NOMcom	NOMB.=s|GENRE=f|CAS=r
venoient	venir	VERcjg	MODE=ind|TEMPS=ipf|PERS.=3|NOMB.=p
entrer	entrer	VERinf	MORPH=empty
cloitre	cloistre	NOMcom	NOMB.=s|GENRE=m|CAS=r
poaient	pöoir	VERcjg	MODE=ind|TEMPS=ipf|PERS.=3|NOMB.=p
region	regïon	NOMcom	NOMB.=s|GENRE=f|CAS=r
venoient	venir	VERcjg	MODE=ind|TEMPS=ipf|PERS.=3|NOMB.=p
procession	processïon	NOMcom	NOMB.=s|GENRE=f|CAS=r
provoires	provoire	NOMcom	NOMB.=p|GENRE=f|CAS=n
parroissiaux	paroissïal	ADJqua	NOMB.=p|GENRE=m|CAS=n|DEGRE=p
amenoient	amener	VERcjg	MODE=ind|TEMPS=ipf|PERS.=3|NOMB.=p
grans	grant	ADJqua	NOMB.=p|GENRE=m|CAS=r|DEGRE=p
tropeaux	tropel	NOMcom	NOMB.=p|GENRE=m|CAS=r
parrossiens	paroissiien	NOMcom	NOMB.=p|GENRE=m|CAS=r
genvres	juene	NOMcom	NOMB.=p|GENRE=m|CAS=r
anciens	anciien	NOMcom	NOMB.=p|GENRE=m|CAS=r
nuiz	nuit	NOMcom	NOMB.=s|GENRE=f|CAS=r
demoraient	demorer	VERcjg	MODE=ind|TEMPS=ipf|PERS.=3|NOMB.=p
cloistre	cloistre	NOMcom	NOMB.=s|GENRE=m|CAS=r
monstier	mostier	NOMcom	NOMB.=s|GENRE=m|CAS=r
veillaient	veillier2	VERcjg	MODE=ind|TEMPS=ipf|PERS.=3|NOMB.=p
clerc	clerc	NOMcom	NOMB.=p|GENRE=m|CAS=n
provoire	provoire	NOMcom	NOMB.=p|GENRE=m|CAS=n
enneur	onor	NOMcom	NOMB.=s|GENRE=x|CAS=r
memoire	memoire	NOMcom	NOMB.=s|GENRE=m|CAS=r
haute	haut	ADJqua	NOMB.=s|GENRE=f|CAS=r|DEGRE=p
dame	dame	NOMcom	NOMB.=s|GENRE=f|CAS=r
ennoree	onorer	VERppe	NOMB.=s|GENRE=f|CAS=r
chantoient	chanter	VERcjg	MODE=ind|TEMPS=ipf|PERS.=3|NOMB.=p
vois	voiz	NOMcom	NOMB.=s|GENRE=f|CAS=r
eslevee	eslever	VERppe	NOMB.=s|GENRE=f|CAS=r
loanges	löenge	NOMcom	NOMB.=p|GENRE=f|CAS=r
enterignes	enterin	ADJqua	NOMB.=p|GENRE=f|CAS=r|DEGRE=p
voirre	voirre	NOMcom	NOMB.=s|GENRE=m|CAS=r
boiche	boche	NOMcom	NOMB.=s|GENRE=f|CAS=r
bouta	boter1	VERcjg	MODE=ind|TEMPS=psp|PERS.=3|NOMB.=s
mein	main2	NOMcom	NOMB.=s|GENRE=f|CAS=r
voirre	voirre	NOMcom	NOMB.=s|GENRE=m|CAS=r
enfant	enfant	NOMcom	NOMB.=s|GENRE=m|CAS=r
mis	metre2	VERppe	NOMB.=s|GENRE=m|CAS=r
bouche	boche	NOMcom	NOMB.=s|GENRE=f|CAS=r
voirre	voirre	NOMcom	NOMB.=s|GENRE=m|CAS=n
glace	glace	NOMcom	NOMB.=s|GENRE=f|CAS=r
resemble	resembler	VERcjg	MODE=ind|TEMPS=pst|PERS.=3|NOMB.=s
esclingdant	esglinder	VERppa	NOMB.=x|GENRE=x|CAS=x
souef	söef	ADJqua	NOMB.=s|GENRE=m|CAS=n|DEGRE=p
plein	plein	ADJqua	NOMB.=s|GENRE=m|CAS=n|DEGRE=p
escoulourja	escolorgier	VERcjg	MODE=ind|TEMPS=psp|PERS.=3|NOMB.=s
mein	main2	NOMcom	NOMB.=s|GENRE=f|CAS=r
coula	coler1	VERcjg	MODE=ind|TEMPS=psp|PERS.=3|NOMB.=s
gorgete	gorgete	NOMcom	NOMB.=s|GENRE=f|CAS=r
ert	estre1	VERcjg	MODE=ind|TEMPS=ipf|PERS.=3|NOMB.=s
estrete	estroit	ADJqua	NOMB.=s|GENRE=f|CAS=n|DEGRE=p
petiteste	petitet	ADJqua	NOMB.=s|GENRE=f|CAS=n|DEGRE=p
gorge	gorge	NOMcom	NOMB.=s|GENRE=f|CAS=n
ert	estre1	VERcjg	MODE=ind|TEMPS=ipf|PERS.=3|NOMB.=s
petite	petit	ADJqua	NOMB.=s|GENRE=f|CAS=n|DEGRE=p
estreite	estroit	ADJqua	NOMB.=s|GENRE=f|CAS=n|DEGRE=p
enfançonneite	enfançonet	NOMcom	NOMB.=s|GENRE=f|CAS=n
fu	estre1	VERcjg	MODE=ind|TEMPS=psp|PERS.=3|NOMB.=s
destreite	detraire	VERppe	NOMB.=s|GENRE=f|CAS=n
molesta	molester	VERcjg	MODE=ind|TEMPS=psp|PERS.=3|NOMB.=s
voirre	voirre	NOMcom	NOMB.=s|GENRE=m|CAS=n
aresta	arester	VERcjg	MODE=ind|TEMPS=psp|PERS.=3|NOMB.=s
Estoupés	estoper	VERppe	NOMB.=s|GENRE=m|CAS=n
fu	estre1	VERcjg	MODE=ind|TEMPS=psp|PERS.=3|NOMB.=s
esperiz	esperit	NOMcom	NOMB.=s|GENRE=m|CAS=n
enfant	enfant	NOMcom	NOMB.=s|GENRE=m|CAS=n
fust	estre1	VERcjg	MODE=sub|TEMPS=ipf|PERS.=3|NOMB.=s
periz	perir	VERppe	NOMB.=s|GENRE=m|CAS=n
issoit	issir	VERcjg	MODE=ind|TEMPS=ipf|PERS.=3|NOMB.=s
fun	fonz	NOMcom	NOMB.=s|GENRE=m|CAS=n
aleine	aleine	NOMcom	NOMB.=s|GENRE=f|CAS=n
chose	chose	NOMcom	NOMB.=s|GENRE=f|CAS=n
est	estre1	VERcjg	MODE=ind|TEMPS=pst|PERS.=3|NOMB.=s
perie	perir	VERppe	NOMB.=s|GENRE=f|CAS=n
mere	mere	NOMcom	NOMB.=s|GENRE=f|CAS=n
breit	braire	VERcjg	MODE=ind|TEMPS=pst|PERS.=3|NOMB.=s
crie	crïer2	VERcjg	MODE=ind|TEMPS=pst|PERS.=3|NOMB.=s
cheveux	chevel	NOMcom	NOMB.=p|GENRE=m|CAS=r
ront	rompre	VERcjg	MODE=ind|TEMPS=pst|PERS.=3|NOMB.=p
descire	descirier	VERcjg	MODE=ind|TEMPS=pst|PERS.=3|NOMB.=p
vis	vis1	NOMcom	NOMB.=s|GENRE=m|CAS=r
esgratine	esgratiner	VERcjg	MODE=ind|TEMPS=pst|PERS.=3|NOMB.=s
empire	empirier	VERcjg	MODE=ind|TEMPS=pst|PERS.=3|NOMB.=s
a	avoir	VERcjg	MODE=ind|TEMPS=pst|PERS.=3|NOMB.=s
fille	fille	NOMcom	NOMB.=s|GENRE=f|CAS=r
bras	braz	NOMcom	NOMB.=p|GENRE=m|CAS=r
prise	prendre	VERppe	NOMB.=s|GENRE=f|CAS=r
aqueult	acoillir	VERcjg	MODE=ind|TEMPS=pst|PERS.=3|NOMB.=s
voie	voie	NOMcom	NOMB.=s|GENRE=f|CAS=r
iglise	eglise	NOMcom	NOMB.=s|GENRE=f|CAS=r
esperance	esperance	NOMcom	NOMB.=s|GENRE=f|CAS=r
foi	foi	NOMcom	NOMB.=s|GENRE=f|CAS=r
creance	crëance	NOMcom	NOMB.=s|GENRE=f|CAS=r
avoit	avoir	VERcjg	MODE=ind|TEMPS=ipf|PERS.=3|NOMB.=s
conceüe	concevoir	VERppe	NOMB.=s|GENRE=f|CAS=r
fu	estre1	VERcjg	MODE=ind|TEMPS=psp|PERS.=3|NOMB.=s
amenteüe	amentevoir	VERppe	NOMB.=s|GENRE=f|CAS=n
dame	dame	NOMcom	NOMB.=s|GENRE=f|CAS=n
sentisme	saintisme	ADJqua	NOMB.=s|GENRE=f|CAS=n|DEGRE=p
fiance	fïance	NOMcom	NOMB.=s|GENRE=f|CAS=r
avoit	avoir	VERcjg	MODE=ind|TEMPS=ipf|PERS.=3|NOMB.=s
haute	haut	ADJqua	NOMB.=s|GENRE=f|CAS=r|DEGRE=p
dame	dame	NOMcom	NOMB.=s|GENRE=f|CAS=r
esmust	esmovoir	VERcjg	MODE=ind|TEMPS=psp|PERS.=3|NOMB.=s
meson	maison	NOMcom	NOMB.=s|GENRE=f|CAS=r
fame	feme	NOMcom	NOMB.=s|GENRE=f|CAS=n
cor	cors1	NOMcom	NOMB.=s|GENRE=m|CAS=r
ot	avoir	VERcjg	MODE=ind|TEMPS=psp|PERS.=3|NOMB.=s
mis	metre2	VERppe	NOMB.=s|GENRE=m|CAS=r
ot	avoir	VERcjg	MODE=ind|TEMPS=psp|PERS.=3|NOMB.=s
haubert	hauberc	NOMcom	NOMB.=s|GENRE=m|CAS=r
bel	bel1	ADJqua	NOMB.=s|GENRE=m|CAS=r|DEGRE=p
gent	gent2	ADJqua	NOMB.=s|GENRE=m|CAS=r|DEGRE=p
espee	espee	NOMcom	NOMB.=s|GENRE=f|CAS=r
tranchant	trenchant	ADJqua	NOMB.=s|GENRE=f|CAS=r|DEGRE=p
alumele	alemele	NOMcom	NOMB.=s|GENRE=f|CAS=r
glaive	glaive	NOMcom	NOMB.=s|GENRE=f|CAS=r
essele	aissele2	NOMcom	NOMB.=s|GENRE=f|CAS=r
grant	grant	ADJqua	NOMB.=s|GENRE=m|CAS=r|DEGRE=p
fer	fer	NOMcom	NOMB.=s|GENRE=m|CAS=r
pointe	pointe	NOMcom	NOMB.=s|GENRE=f|CAS=r
acier	acier	NOMcom	NOMB.=s|GENRE=m|CAS=r
defier	desfïer	VERinf	MORPH=empty
menacier	menacier	VERinf	MORPH=empty
chevalier	chevalier	NOMcom	NOMB.=s|GENRE=m|CAS=r
corurent	corir	VERcjg	MODE=ind|TEMPS=psp|PERS.=3|NOMB.=p
a	avoir	VERcjg	MODE=ind|TEMPS=pst|PERS.=3|NOMB.=s
queure	corir	VERcjg	MODE=sub|TEMPS=pst|PERS.=3|NOMB.=s
chevalier	chevalier	NOMcom	NOMB.=s|GENRE=m|CAS=n
fu	estre1	VERcjg	MODE=ind|TEMPS=psp|PERS.=3|NOMB.=s
envaï	enväir	VERppe	NOMB.=s|GENRE=m|CAS=n
estoit	estre1	VERcjg	MODE=ind|TEMPS=ipf|PERS.=3|NOMB.=s
haï	häir	VERppe	NOMB.=s|GENRE=m|CAS=n
esjoïssoient	esjöir	VERcjg	MODE=ind|TEMPS=ipf|PERS.=3|NOMB.=p
ocirre	ocire	VERinf	MORPH=empty
quidoient	cuidier1	VERcjg	MODE=ind|TEMPS=ipf|PERS.=3|NOMB.=p
asaillirent	assalir	VERcjg	MODE=ind|TEMPS=psp|PERS.=3|NOMB.=p
glaives	glaive	NOMcom	NOMB.=p|GENRE=f|CAS=r
tranchans	trenchant	ADJqua	NOMB.=p|GENRE=f|CAS=r|DEGRE=p
ferirent	ferir	VERcjg	MODE=ind|TEMPS=psp|PERS.=3|NOMB.=p
robe	robe	NOMcom	NOMB.=s|GENRE=f|CAS=r
ont	avoir	VERcjg	MODE=ind|TEMPS=pst|PERS.=3|NOMB.=p
perciee	percier	VERppe	NOMB.=s|GENRE=f|CAS=r
chemise	chemise	NOMcom	NOMB.=s|GENRE=f|CAS=n
delïee	deliier	VERppe	NOMB.=s|GENRE=f|CAS=n
fu	estre1	VERcjg	MODE=ind|TEMPS=psp|PERS.=3|NOMB.=s
perciee	percier	VERppe	NOMB.=s|GENRE=f|CAS=n
entamee	entamer	VERppe	NOMB.=s|GENRE=f|CAS=n
robe	robe	NOMcom	NOMB.=s|GENRE=f|CAS=r
ont	avoir	VERcjg	MODE=ind|TEMPS=pst|PERS.=3|NOMB.=p
perciee	percier	VERppe	NOMB.=s|GENRE=f|CAS=r
esbahi	esbäir	VERcjg	MODE=ind|TEMPS=psp|PERS.=3|NOMB.=s
savoit	savoir	VERcjg	MODE=ind|TEMPS=ipf|PERS.=3|NOMB.=s
ert	estre1	VERcjg	MODE=ind|TEMPS=ipf|PERS.=3|NOMB.=s
voir	voir	NOMcom	NOMB.=s|GENRE=m|CAS=n
mençonge	mençogne	NOMcom	NOMB.=s|GENRE=m|CAS=r
ert	estre1	VERcjg	MODE=ind|TEMPS=ipf|PERS.=3|NOMB.=s
vision	visïon	NOMcom	NOMB.=s|GENRE=f|CAS=n
songe	songe	NOMcom	NOMB.=s|GENRE=m|CAS=r
averti	avertir2	VERcjg	MODE=ind|TEMPS=psp|PERS.=3|NOMB.=s
remenbrance	remembrance	NOMcom	NOMB.=s|GENRE=f|CAS=r
est	estre1	VERcjg	MODE=ind|TEMPS=pst|PERS.=3|NOMB.=s
grant	grant	ADJqua	NOMB.=s|GENRE=f|CAS=n|DEGRE=p
puissance	poissance	NOMcom	NOMB.=s|GENRE=f|CAS=n
soverain	soverain	ADJqua	NOMB.=s|GENRE=m|CAS=r|DEGRE=p
pere	pere	NOMcom	NOMB.=s|GENRE=m|CAS=r
delivra	delivrer	VERcjg	MODE=ind|TEMPS=psp|PERS.=3|NOMB.=s
saint	saint	ADJqua	NOMB.=s|GENRE=m|CAS=r|DEGRE=p
lïens	liien	NOMcom	NOMB.=p|GENRE=m|CAS=r
deschaënna	deschäener	VERcjg	MODE=ind|TEMPS=psp|PERS.=3|NOMB.=s
ange	angele	NOMcom	NOMB.=s|GENRE=m|CAS=r
mena	mener	VERcjg	MODE=ind|TEMPS=psp|PERS.=3|NOMB.=s
gita	jeter	VERcjg	MODE=ind|TEMPS=psp|PERS.=3|NOMB.=s
prison	prison	NOMcom	NOMB.=s|GENRE=f|CAS=r
chevalier	chevalier	NOMcom	NOMB.=s|GENRE=m|CAS=n
lison	lire1	VERcjg	MODE=ind|TEMPS=pst|PERS.=1|NOMB.=p
gardaient	garder	VERcjg	MODE=ind|TEMPS=ipf|PERS.=3|NOMB.=p
perdirent	perdre	VERcjg	MODE=ind|TEMPS=psp|PERS.=3|NOMB.=p
eissir	issir	NOMcom	NOMB.=x|GENRE=x|CAS=x
virent	vëoir	VERcjg	MODE=ind|TEMPS=psp|PERS.=3|NOMB.=p
est	estre1	VERcjg	MODE=ind|TEMPS=pst|PERS.=3|NOMB.=s
manière	maniere	NOMcom	NOMB.=s|GENRE=f|CAS=r
poissant	poissant	ADJqua	NOMB.=s|GENRE=m|CAS=n|DEGRE=p
priere	priiere	NOMcom	NOMB.=s|GENRE=f|CAS=r
douce	douz	ADJqua	NOMB.=s|GENRE=f|CAS=r|DEGRE=p
mere	mere	NOMcom	NOMB.=s|GENRE=f|CAS=r
reconte	reconter	VERcjg	MODE=ind|TEMPS=pst|PERS.=3|NOMB.=s
écripture	escriture	NOMcom	NOMB.=s|GENRE=f|CAS=n
chanoine	chanoine	NOMcom	NOMB.=s|GENRE=m|CAS=n
ville	vile	NOMcom	NOMB.=s|GENRE=f|CAS=r
avoit	avoir	VERcjg	MODE=ind|TEMPS=ipf|PERS.=3|NOMB.=s
non	nom	NOMcom	NOMB.=s|GENRE=m|CAS=r
dit	dire	VERcjg	MODE=ind|TEMPS=pst|PERS.=3|NOMB.=s
escrit	escrit	NOMcom	NOMB.=s|GENRE=m|CAS=n
preuzdom	prodome	NOMcom	NOMB.=s|GENRE=m|CAS=n
cremoit	criembre	VERcjg	MODE=ind|TEMPS=ipf|PERS.=3|NOMB.=s
esseia	essaiier	VERcjg	MODE=ind|TEMPS=psp|PERS.=3|NOMB.=s
asemblee	assemblee	NOMcom	NOMB.=s|GENRE=f|CAS=r
seul	sol1	ADJqua	NOMB.=s|GENRE=m|CAS=r|DEGRE=p
espi	espi	NOMcom	NOMB.=s|GENRE=m|CAS=r
mannee	manee	NOMcom	NOMB.=s|GENRE=f|CAS=r
peüst	pöoir	VERcjg	MODE=sub|TEMPS=ipf|PERS.=3|NOMB.=s
oster	oster2	VERinf	MORPH=empty
arrachier	arrachier	VERinf	MORPH=empty
tirer	tirer	VERinf	MORPH=empty
sachier	sachier2	VERinf	MORPH=empty
erent	estre1	VERcjg	MODE=ind|TEMPS=ipf|PERS.=3|NOMB.=p
clerc	clerc	NOMcom	NOMB.=p|GENRE=m|CAS=n
lei	lai3	NOMcom	NOMB.=p|GENRE=m|CAS=n
essaierent	essaiier	VERcjg	MODE=ind|TEMPS=psp|PERS.=3|NOMB.=p
porent	pöoir	VERcjg	MODE=ind|TEMPS=psp|PERS.=3|NOMB.=p
feire	faire	VERinf	MORPH=empty
espi	espi	NOMcom	NOMB.=s|GENRE=m|CAS=r
peüssent	pöoir	VERcjg	MODE=sub|TEMPS=ipf|PERS.=3|NOMB.=p
treire	traire	VERinf	MORPH=empty
vit	vëoir	VERcjg	MODE=ind|TEMPS=psp|PERS.=3|NOMB.=s
prestre	prestre	NOMcom	NOMB.=s|GENRE=m|CAS=n
oï	öir	VERcjg	MODE=ind|TEMPS=psp|PERS.=3|NOMB.=s
pleinz	plaint	NOMcom	NOMB.=p|GENRE=m|CAS=r
pleurs	plor	NOMcom	NOMB.=p|GENRE=m|CAS=r
parroisiens	paroissiien	NOMcom	NOMB.=p|GENRE=m|CAS=n
fesoient	faire	VERcjg	MODE=ind|TEMPS=ipf|PERS.=3|NOMB.=p
pié	pié	NOMcom	NOMB.=s|GENRE=m|CAS=r
salt	salir2	VERcjg	MODE=ind|TEMPS=pst|PERS.=3|NOMB.=s
ist	issir	VERcjg	MODE=ind|TEMPS=pst|PERS.=3|NOMB.=s
corre	corir	VERinf	MORPH=empty
fine	finer	VERcjg	MODE=ind|TEMPS=pst|PERS.=3|NOMB.=s
puente	püant	ADJqua	NOMB.=s|GENRE=f|CAS=n|DEGRE=p
puazine	püasine	NOMcom	NOMB.=s|GENRE=f|CAS=n
moustier	mostier	NOMcom	NOMB.=s|GENRE=m|CAS=r
crient	crïer2	VERcjg	MODE=ind|TEMPS=pst|PERS.=3|NOMB.=p
gardes	garde	NOMcom	NOMB.=p|GENRE=m|CAS=r
plorant	plorer	VERppa	NOMB.=x|GENRE=x|CAS=x
prient	priier	VERcjg	MODE=ind|TEMPS=pst|PERS.=3|NOMB.=p
meite	metre2	VERcjg	MODE=sub|TEMPS=pst|PERS.=3|NOMB.=s
put	püir	VERcjg	MODE=ind|TEMPS=pst|PERS.=3|NOMB.=s
fet	faire	VERcjg	MODE=ind|TEMPS=pst|PERS.=3|NOMB.=s
seite	sete	NOMcom	NOMB.=s|GENRE=f|CAS=n
est	estre1	VERcjg	MODE=ind|TEMPS=pst|PERS.=3|NOMB.=s
boutez	boter1	VERppe	NOMB.=s|GENRE=m|CAS=n
huis	uis	NOMcom	NOMB.=s|GENRE=m|CAS=r
est	estre1	VERcjg	MODE=ind|TEMPS=pst|PERS.=3|NOMB.=s
acoutez	acoter	VERppe	NOMB.=s|GENRE=m|CAS=n
pleure	plorer	VERcjg	MODE=ind|TEMPS=pst|PERS.=3|NOMB.=s
bret	braire	VERcjg	MODE=ind|TEMPS=pst|PERS.=3|NOMB.=s
huche	huchier1	VERcjg	MODE=ind|TEMPS=pst|PERS.=3|NOMB.=s
crie	crïer2	VERcjg	MODE=ind|TEMPS=pst|PERS.=3|NOMB.=s
Douce	douz	ADJqua	NOMB.=s|GENRE=f|CAS=n|DEGRE=p
dame	dame	NOMcom	NOMB.=s|GENRE=f|CAS=n
sainte	saint	ADJqua	NOMB.=s|GENRE=f|CAS=n|DEGRE=p
yglise	eglise	NOMcom	NOMB.=s|GENRE=f|CAS=r
boute	boter1	VERcjg	MODE=ind|TEMPS=pst|PERS.=3|NOMB.=s
sui	estre1	VERcjg	MODE=ind|TEMPS=pst|PERS.=1|NOMB.=s
sers	serf	NOMcom	NOMB.=s|GENRE=m|CAS=n
hom	ome	NOMcom	NOMB.=s|GENRE=m|CAS=n
vile	vile	NOMcom	NOMB.=s|GENRE=f|CAS=r
nez	naistre	VERppe	NOMB.=s|GENRE=m|CAS=n
Seigneurs	seignor	NOMcom	NOMB.=p|GENRE=m|CAS=n
fet	faire	VERcjg	MODE=ind|TEMPS=pst|PERS.=3|NOMB.=s
vilenez	vilener	VERcjg	MODE=ind|TEMPS=pst|PERS.=2|NOMB.=p
boutez	boter1	VERcjg	MODE=ind|TEMPS=pst|PERS.=2|NOMB.=p
chien	chien	NOMcom	NOMB.=s|GENRE=m|CAS=r
