form	lemma	POS	morph
joel	jöel	NOMcom	NOMB.=s|GENRE=m|CAS=r
per	per	NOMcom	NOMB.=s|GENRE=m|CAS=r
grant	grant	ADJqua	NOMB.=s|GENRE=f|CAS=r|DEGRE=p
maistrise	maistrise	NOMcom	NOMB.=s|GENRE=f|CAS=r
Las	las	ADJqua	NOMB.=s|GENRE=m|CAS=n|DEGRE=p
bontey	bonté	NOMcom	NOMB.=s|GENRE=f|CAS=n
valour	valor	NOMcom	NOMB.=s|GENRE=f|CAS=n
fait	faire	VERcjg	MODE=ind|TEMPS=pst|PERS.=3|NOMB.=s
froit	froit1	NOMcom	NOMB.=s|GENRE=m|CAS=r
chalour	chalor	NOMcom	NOMB.=s|GENRE=f|CAS=r
Estrange	estrange	ADJqua	NOMB.=s|GENRE=f|CAS=n|DEGRE=p
est	estre1	VERcjg	MODE=ind|TEMPS=pst|PERS.=3|NOMB.=s
nature	nature	NOMcom	NOMB.=s|GENRE=f|CAS=n
truis	trover	VERcjg	MODE=ind|TEMPS=pst|PERS.=1|NOMB.=s
pasture	pasture1	NOMcom	NOMB.=s|GENRE=f|CAS=r
ainz	amer1	VERcjg	MODE=ind|TEMPS=pst|PERS.=1|NOMB.=s
grains	grain	NOMcom	NOMB.=p|GENRE=m|CAS=r
fromant	forment	NOMcom	NOMB.=s|GENRE=m|CAS=r
orge	orge	NOMcom	NOMB.=s|GENRE=f|CAS=r
font	faire	VERcjg	MODE=ind|TEMPS=pst|PERS.=3|NOMB.=p
ovrir	ovrir	VERinf	MORPH=empty
gorge	gorge	NOMcom	NOMB.=s|GENRE=f|CAS=r
entent	entendre	VERcjg	MODE=imp|PERS.=2|NOMB.=s
moralitey	mortalité	NOMcom	NOMB.=s|GENRE=f|CAS=r
prent	prendre	VERcjg	MODE=imp|PERS.=2|NOMB.=s
auctoritey	autorité	NOMcom	NOMB.=s|GENRE=f|CAS=r
riche	riche	ADJqua	NOMB.=s|GENRE=f|CAS=r|DEGRE=p
jaspe	jaspe	NOMcom	NOMB.=s|GENRE=f|CAS=r
est	estre1	VERcjg	MODE=ind|TEMPS=pst|PERS.=3|NOMB.=s
savoir	savoir	VERinf	MORPH=empty
fox	fol3	NOMcom	NOMB.=s|GENRE=m|CAS=n
pous	pol3	NOMcom	NOMB.=p|GENRE=m|CAS=r
puet	pöoir	VERcjg	MODE=ind|TEMPS=pst|PERS.=3|NOMB.=s
avoir	avoir	VERinf	MORPH=empty
Bone	bon	ADJqua	NOMB.=s|GENRE=f|CAS=n|DEGRE=p
est	estre1	VERcjg	MODE=ind|TEMPS=pst|PERS.=3|NOMB.=s
comparoison	compagnon	NOMcom	NOMB.=s|GENRE=f|CAS=n
foul	fol3	NOMcom	NOMB.=s|GENRE=m|CAS=r
poul	pol3	NOMcom	NOMB.=s|GENRE=m|CAS=r
est	estre1	VERcjg	MODE=ind|TEMPS=pst|PERS.=3|NOMB.=s
raison	raison	NOMcom	NOMB.=s|GENRE=f|CAS=r
Sapience	sapïence	NOMcom	NOMB.=s|GENRE=f|CAS=n
est	estre1	VERcjg	MODE=ind|TEMPS=pst|PERS.=3|NOMB.=s
espandue	espandre	VERppe	NOMB.=s|GENRE=f|CAS=n
fous	fol3	NOMcom	NOMB.=s|GENRE=m|CAS=r
est	estre1	VERcjg	MODE=ind|TEMPS=pst|PERS.=3|NOMB.=s
chose	chose	NOMcom	NOMB.=s|GENRE=f|CAS=n
perdue	perdre	VERppe	NOMB.=s|GENRE=f|CAS=n
Beax	bel1	ADJqua	NOMB.=s|GENRE=m|CAS=n|DEGRE=p
fiz	fil2	NOMcom	NOMB.=s|GENRE=m|CAS=n
ovre	ovrir	VERcjg	MODE=imp|PERS.=2|NOMB.=s
porte	porte1	NOMcom	NOMB.=s|GENRE=f|CAS=r
lait	lait3	NOMcom	NOMB.=s|GENRE=m|CAS=r
ai	avoir	VERcjg	MODE=ind|TEMPS=pst|PERS.=1|NOMB.=s
guardé	garder	VERppe	NOMB.=s|GENRE=m|CAS=r
aporte	aporter	VERcjg	MODE=ind|TEMPS=pst|PERS.=1|NOMB.=s
chevriz	chevri	NOMcom	NOMB.=s|GENRE=m|CAS=n
dit	dire	VERcjg	MODE=ind|TEMPS=pst|PERS.=3|NOMB.=s
Fous	fol3	NOMcom	NOMB.=s|GENRE=m|CAS=n
perillous	perillos	ADJqua	NOMB.=s|GENRE=m|CAS=n|DEGRE=p
conois	conoistre	VERcjg	MODE=ind|TEMPS=pst|PERS.=1|NOMB.=s
es	estre1	VERcjg	MODE=ind|TEMPS=pst|PERS.=2|NOMB.=s
lous	lou	NOMcom	NOMB.=s|GENRE=m|CAS=n
Este	este	NOMcom	NOMB.=s|GENRE=f|CAS=n
lai	lai3	NOMcom	NOMB.=s|GENRE=m|CAS=r
faus	faus	ADJqua	NOMB.=s|GENRE=m|CAS=n|DEGRE=p
chivroterres	chevrotëor	NOMcom	NOMB.=s|GENRE=m|CAS=n
samble	sembler	VERcjg	MODE=ind|TEMPS=pst|PERS.=2|NOMB.=s
estre	estre1	VERinf	MORPH=empty
lerres	larron	NOMcom	NOMB.=s|GENRE=m|CAS=n
vuez	voloir	VERcjg	MODE=ind|TEMPS=pst|PERS.=2|NOMB.=s
mere	mere	NOMcom	NOMB.=s|GENRE=f|CAS=r
sambler	sembler	VERinf	MORPH=empty
puisses	pöoir	VERcjg	MODE=sub|TEMPS=pst|PERS.=2|NOMB.=s
ambler	embler	VERinf	MORPH=empty
vois	vëoir	VERcjg	MODE=ind|TEMPS=pst|PERS.=1|NOMB.=s
grevaice	crevace	NOMcom	NOMB.=s|GENRE=f|CAS=r
sai	savoir	VERcjg	MODE=ind|TEMPS=pst|PERS.=1|NOMB.=s
conoistre	conoistre	VERinf	MORPH=empty
face	face	NOMcom	NOMB.=s|GENRE=f|CAS=r
pri	priier	VERcjg	MODE=ind|TEMPS=pst|PERS.=1|NOMB.=s
chivroter	chevroter	NOMcom	NOMB.=x|GENRE=x|CAS=x
va	aler	VERcjg	MODE=imp|PERS.=2|NOMB.=s
puis	pöoir	VERcjg	MODE=ind|TEMPS=pst|PERS.=1|NOMB.=s
doter	doter2	VERinf	MORPH=empty
filz	fil2	NOMcom	NOMB.=s|GENRE=m|CAS=n
tient	tenir1	VERcjg	MODE=ind|TEMPS=pst|PERS.=3|NOMB.=s
ensoignemant	enseignement	NOMcom	NOMB.=s|GENRE=m|CAS=r
pere	pere	NOMcom	NOMB.=s|GENRE=m|CAS=r
vit	vivre1	VERcjg	MODE=ind|TEMPS=pst|PERS.=3|NOMB.=s
vuet	voloir	VERcjg	MODE=ind|TEMPS=pst|PERS.=3|NOMB.=s
retenir	retenir	VERinf	MORPH=empty
poinnes	peine	NOMcom	NOMB.=p|GENRE=f|CAS=r
puet	pöoir	VERcjg	MODE=ind|TEMPS=pst|PERS.=3|NOMB.=s
bien	bien2	NOMcom	NOMB.=s|GENRE=m|CAS=r
venir	venir	VERinf	MORPH=empty
dura	durer	VERcjg	MODE=ind|TEMPS=psp|PERS.=3|NOMB.=s
bataille	bataille	NOMcom	NOMB.=s|GENRE=f|CAS=n
sont	estre1	VERcjg	MODE=ind|TEMPS=pst|PERS.=3|NOMB.=p
las	las	ADJqua	NOMB.=s|GENRE=m|CAS=n|DEGRE=p
est	estre1	VERcjg	MODE=ind|TEMPS=pst|PERS.=3|NOMB.=s
essaille	assalir	VERcjg	MODE=sub|TEMPS=pst|PERS.=3|NOMB.=s
os	ost	NOMcom	NOMB.=s|GENRE=m|CAS=n
reposent	reposer	VERcjg	MODE=ind|TEMPS=pst|PERS.=3|NOMB.=p
lous	lou	NOMcom	NOMB.=p|GENRE=m|CAS=n
berbiz	brebiz	NOMcom	NOMB.=p|GENRE=f|CAS=r
pais	pais	NOMcom	NOMB.=s|GENRE=f|CAS=r
proposent	proposer	VERcjg	MODE=ind|TEMPS=pst|PERS.=3|NOMB.=p
pais	pais	NOMcom	NOMB.=s|GENRE=f|CAS=r
concorde	concorde	NOMcom	NOMB.=s|GENRE=f|CAS=r
presantent	presenter	VERcjg	MODE=ind|TEMPS=pst|PERS.=3|NOMB.=p
consantent	consentir	VERcjg	MODE=ind|TEMPS=pst|PERS.=3|NOMB.=p
trieves	trieue	NOMcom	NOMB.=p|GENRE=f|CAS=r
prirent	prendre	VERcjg	MODE=ind|TEMPS=psp|PERS.=3|NOMB.=p
soiremant	sairement	NOMcom	NOMB.=s|GENRE=m|CAS=r
ont	avoir	VERcjg	MODE=ind|TEMPS=pst|PERS.=3|NOMB.=p
fermés	fermer	VERppe	NOMB.=p|GENRE=m|CAS=r
furent	estre1	VERcjg	MODE=ind|TEMPS=psp|PERS.=3|NOMB.=p
trieves	trieue	NOMcom	NOMB.=p|GENRE=f|CAS=n
prises	prendre	VERppe	NOMB.=p|GENRE=f|CAS=n
pars	part1	NOMcom	NOMB.=p|GENRE=f|CAS=r
sont	estre1	VERcjg	MODE=ind|TEMPS=pst|PERS.=3|NOMB.=p
plaiges	pleige	NOMcom	NOMB.=p|GENRE=f|CAS=n
mises	metre2	VERppe	NOMB.=p|GENRE=f|CAS=n
berbiz	brebiz	NOMcom	NOMB.=p|GENRE=f|CAS=n
donent	doner	VERcjg	MODE=ind|TEMPS=pst|PERS.=3|NOMB.=p
ostaiges	ostage2	NOMcom	NOMB.=p|GENRE=m|CAS=r
chiens	chien	NOMcom	NOMB.=p|GENRE=m|CAS=r
moutons	mouton	NOMcom	NOMB.=p|GENRE=m|CAS=r
prirent	prendre	VERcjg	MODE=ind|TEMPS=psp|PERS.=3|NOMB.=p
gaiges	gage	NOMcom	NOMB.=p|GENRE=m|CAS=r
louez	love	NOMcom	NOMB.=p|GENRE=f|CAS=r
baillarent	baillier	VERcjg	MODE=ind|TEMPS=psp|PERS.=3|NOMB.=p
menarent	mener	VERcjg	MODE=ind|TEMPS=psp|PERS.=3|NOMB.=p
perçoivent	perçoivre	VERcjg	MODE=ind|TEMPS=pst|PERS.=3|NOMB.=p
grant	grant	ADJqua	NOMB.=s|GENRE=m|CAS=r|DEGRE=p
domaige	damage	NOMcom	NOMB.=s|GENRE=m|CAS=r
berbiez	brebiz	NOMcom	NOMB.=p|GENRE=f|CAS=n
simple	simple	ADJqua	NOMB.=s|GENRE=m|CAS=r|DEGRE=p
coraige	corage	NOMcom	NOMB.=s|GENRE=m|CAS=r
