form	lemma	POS	morph
est	estre1	VERcjg	MODE=ind|TEMPS=pst|PERS.=3|NOMB.=s
mervelles	merveille	NOMcom	NOMB.=s|GENRE=f|CAS=n
vilain	vilain	NOMcom	NOMB.=s|GENRE=m|CAS=n
ies	estre1	VERcjg	MODE=ind|TEMPS=pst|PERS.=2|NOMB.=s
rice	riche	ADJqua	NOMB.=s|GENRE=m|CAS=n|DEGRE=p
Oiés	öir	VERcjg	MODE=imp|PERS.=2|NOMB.=p
seignor	seignor	NOMcom	NOMB.=p|GENRE=m|CAS=n
croisse	croistre	VERcjg	MODE=sub|TEMPS=pst|PERS.=3|NOMB.=s
bonté	bonté	NOMcom	NOMB.=s|GENRE=f|CAS=r
glorious	glorïos	ADJqua	NOMB.=s|GENRE=m|CAS=n|DEGRE=p
crois	croiz	NOMcom	NOMB.=s|GENRE=f|CAS=r
fu	estre1	VERcjg	MODE=ind|TEMPS=psp|PERS.=3|NOMB.=s
pené	pener	VERppe	NOMB.=s|GENRE=m|CAS=n
orrés	öir	VERcjg	MODE=ind|TEMPS=fut|PERS.=2|NOMB.=p
canchon	chançon	NOMcom	NOMB.=s|GENRE=f|CAS=r
grant	grant	ADJqua	NOMB.=s|GENRE=f|CAS=r|DEGRE=p
nobilité	nobilité	NOMcom	NOMB.=s|GENRE=f|CAS=r
est	estre1	VERcjg	MODE=ind|TEMPS=pst|PERS.=3|NOMB.=s
grant	grant	ADJqua	NOMB.=s|GENRE=m|CAS=r|DEGRE=p
peril	peril	NOMcom	NOMB.=s|GENRE=m|CAS=r
rois	roi2	NOMcom	NOMB.=s|GENRE=m|CAS=n
est	estre1	VERcjg	MODE=ind|TEMPS=pst|PERS.=3|NOMB.=s
desmesurés	desmesurer	VERppe	NOMB.=s|GENRE=m|CAS=n
felons	felon	ADJqua	NOMB.=s|GENRE=m|CAS=n|DEGRE=p
puet	pöoir	VERcjg	MODE=ind|TEMPS=pst|PERS.=3|NOMB.=s
estre	estre1	VERinf	MORPH=empty
trovés	trover	VERppe	NOMB.=s|GENRE=m|CAS=n
volsist	voloir	VERcjg	MODE=sub|TEMPS=ipf|PERS.=3|NOMB.=s
justichier	justicier1	VERinf	MORPH=empty
regne	regne	NOMcom	NOMB.=s|GENRE=m|CAS=r
esgarde	esgarder	VERcjg	MODE=ind|TEMPS=pst|PERS.=3|NOMB.=s
a	avoir	VERcjg	MODE=ind|TEMPS=pst|PERS.=3|NOMB.=s
demandé	demander	VERppe	NOMB.=s|GENRE=m|CAS=r
aparchut	apercevoir	VERcjg	MODE=ind|TEMPS=psp|PERS.=3|NOMB.=s
bouche	boche	NOMcom	NOMB.=s|GENRE=f|CAS=r
nés	nase	NOMcom	NOMB.=s|GENRE=m|CAS=r
membra	membrer2	VERcjg	MODE=ind|TEMPS=psp|PERS.=3|NOMB.=s
marcis	marchis	NOMcom	NOMB.=s|GENRE=m|CAS=r
honoré	onorer	VERppe	NOMB.=s|GENRE=m|CAS=r
pere	pere	NOMcom	NOMB.=s|GENRE=m|CAS=r
barbé	barbé	ADJqua	NOMB.=s|GENRE=m|CAS=r|DEGRE=p
lignage	lignage	NOMcom	NOMB.=s|GENRE=m|CAS=r
avoit	avoir	VERcjg	MODE=ind|TEMPS=ipf|PERS.=3|NOMB.=s
grevé	grever	VERppe	NOMB.=s|GENRE=m|CAS=r
souvint	sovenir	VERcjg	MODE=ind|TEMPS=psp|PERS.=3|NOMB.=s
est	estre1	VERcjg	MODE=ind|TEMPS=pst|PERS.=3|NOMB.=s
dervé	desver	VERppe	NOMB.=s|GENRE=m|CAS=n
sans	sanc	NOMcom	NOMB.=s|GENRE=m|CAS=n
est	estre1	VERcjg	MODE=ind|TEMPS=pst|PERS.=3|NOMB.=s
cors	cors1	NOMcom	NOMB.=s|GENRE=m|CAS=r
mué	müer	VERppe	NOMB.=s|GENRE=m|CAS=n
sui	estre1	VERcjg	MODE=ind|TEMPS=pst|PERS.=1|NOMB.=s
donés	doner	VERppe	NOMB.=s|GENRE=m|CAS=n
prendoie	prendre	VERcjg	MODE=ind|TEMPS=ipf|PERS.=1|NOMB.=s
doignon	donjon	NOMcom	NOMB.=s|GENRE=m|CAS=r
fermeté	fermeté	NOMcom	NOMB.=s|GENRE=f|CAS=r
somiers	somier2	NOMcom	NOMB.=s|GENRE=m|CAS=r
or	or1	NOMcom	NOMB.=s|GENRE=m|CAS=r
argent	argent	NOMcom	NOMB.=s|GENRE=m|CAS=r
trousé	torser2	VERppe	NOMB.=p|GENRE=m|CAS=r
fust	estre1	VERcjg	MODE=sub|TEMPS=ipf|PERS.=3|NOMB.=s
cevals	cheval	NOMcom	NOMB.=p|GENRE=m|CAS=r
trainés	träiner	VERppe	NOMB.=s|GENRE=m|CAS=n
pendus	pendre	VERppe	NOMB.=s|GENRE=m|CAS=n
forques	forche	NOMcom	NOMB.=p|GENRE=f|CAS=r
vent	vent	NOMcom	NOMB.=s|GENRE=m|CAS=r
encroés	encröer	VERppe	NOMB.=s|GENRE=m|CAS=n
ars	ardre	VERppe	NOMB.=s|GENRE=m|CAS=n
feu	feu	NOMcom	NOMB.=s|GENRE=m|CAS=r
poudre	poudre	NOMcom	NOMB.=s|GENRE=f|CAS=n
venté	venter	VERppe	NOMB.=s|GENRE=f|CAS=n
ot	öir	VERcjg	MODE=ind|TEMPS=psp|PERS.=3|NOMB.=s
a	avoir	VERcjg	MODE=ind|TEMPS=pst|PERS.=3|NOMB.=s
ris	ris1	NOMcom	NOMB.=s|GENRE=m|CAS=r
jeté	jeter	VERppe	NOMB.=s|GENRE=m|CAS=r
Sire	seignor	NOMcom	NOMB.=s|GENRE=m|CAS=n
dist	dire	VERcjg	MODE=ind|TEMPS=psp|PERS.=3|NOMB.=s
entendés	entendre	VERcjg	MODE=imp|PERS.=2|NOMB.=p
cose	chose	NOMcom	NOMB.=s|GENRE=f|CAS=r
demandés	demander	VERcjg	MODE=ind|TEMPS=pst|PERS.=2|NOMB.=p
dirai	dire	VERcjg	MODE=ind|TEMPS=fut|PERS.=1|NOMB.=s
grés	gré2	NOMcom	NOMB.=p|GENRE=m|CAS=r
fui	estre1	VERcjg	MODE=ind|TEMPS=psp|PERS.=1|NOMB.=s
jouenes	juene	ADJqua	NOMB.=s|GENRE=m|CAS=n|DEGRE=p
petit	petit	ADJqua	NOMB.=s|GENRE=m|CAS=r|DEGRE=p
aé	aé	NOMcom	NOMB.=s|GENRE=m|CAS=r
estoie	estre1	VERcjg	MODE=ind|TEMPS=ipf|PERS.=1|NOMB.=s
leres	larron	NOMcom	NOMB.=s|GENRE=m|CAS=n
ert	estre1	VERcjg	MODE=ind|TEMPS=fut|PERS.=3|NOMB.=s
celé	celer1	VERppe	NOMB.=s|GENRE=m|CAS=n
copoie	coper	VERcjg	MODE=ind|TEMPS=ipf|PERS.=1|NOMB.=s
borses	borse	NOMcom	NOMB.=p|GENRE=f|CAS=r
grans	grant	ADJqua	NOMB.=p|GENRE=m|CAS=r|DEGRE=p
gorles	gorle	NOMcom	NOMB.=p|GENRE=m|CAS=r
fermés	fermer	VERppe	NOMB.=p|GENRE=m|CAS=r
fui	estre1	VERcjg	MODE=ind|TEMPS=psp|PERS.=1|NOMB.=s
pris	prendre	VERppe	NOMB.=s|GENRE=m|CAS=n
marcheans	marchëant	NOMcom	NOMB.=p|GENRE=m|CAS=r
senés	sené2	ADJqua	NOMB.=p|GENRE=m|CAS=r|DEGRE=p
coutiaus	coutel	NOMcom	NOMB.=p|GENRE=m|CAS=r
colperent	coper	VERcjg	MODE=ind|TEMPS=psp|PERS.=3|NOMB.=p
nés	nase	NOMcom	NOMB.=s|GENRE=m|CAS=r
lesserent	laissier	VERcjg	MODE=ind|TEMPS=psp|PERS.=3|NOMB.=p
monterent	monter	VERcjg	MODE=ind|TEMPS=psp|PERS.=3|NOMB.=p
destre	destre	NOMcom	NOMB.=s|GENRE=x|CAS=r
cit	cit	NOMcom	NOMB.=s|GENRE=f|CAS=r
lessierent	laissier	VERcjg	MODE=ind|TEMPS=psp|PERS.=3|NOMB.=p
riches	riche	ADJqua	NOMB.=p|GENRE=f|CAS=r|DEGRE=p
herberges	herberge	NOMcom	NOMB.=p|GENRE=f|CAS=r
vile	vile	NOMcom	NOMB.=s|GENRE=f|CAS=r
vorrent	voloir	VERcjg	MODE=ind|TEMPS=psp|PERS.=3|NOMB.=p
mal	mal1	NOMcom	NOMB.=s|GENRE=m|CAS=r
fere	faire	VERinf	MORPH=empty
nuit	nuit	NOMcom	NOMB.=s|GENRE=f|CAS=r
jurent	jesir	VERcjg	MODE=ind|TEMPS=psp|PERS.=3|NOMB.=p
matin	matin2	NOMcom	NOMB.=s|GENRE=m|CAS=r
tornerent	torner	VERcjg	MODE=ind|TEMPS=psp|PERS.=3|NOMB.=p
cueillent	coillir	VERcjg	MODE=ind|TEMPS=pst|PERS.=3|NOMB.=p
tres	tref2	NOMcom	NOMB.=p|GENRE=m|CAS=r
paveillons	paveillon	NOMcom	NOMB.=p|GENRE=m|CAS=r
deublerent	dobler	VERcjg	MODE=ind|TEMPS=psp|PERS.=3|NOMB.=p
aucubes	aucube	NOMcom	NOMB.=p|GENRE=f|CAS=r
somiers	somier2	NOMcom	NOMB.=p|GENRE=m|CAS=r
trosserent	torser2	VERcjg	MODE=ind|TEMPS=psp|PERS.=3|NOMB.=p
mi	mi2	NOMcom	NOMB.=s|GENRE=m|CAS=r
forez	forest	NOMcom	NOMB.=p|GENRE=f|CAS=r
bois	bois	NOMcom	NOMB.=p|GENRE=m|CAS=r
chevauchierent	chevauchier	VERcjg	MODE=ind|TEMPS=psp|PERS.=3|NOMB.=p
trespasserent	trespasser	VERcjg	MODE=ind|TEMPS=psp|PERS.=3|NOMB.=p
aresterent	arester	VERcjg	MODE=ind|TEMPS=psp|PERS.=3|NOMB.=p
quens	conte1	NOMcom	NOMB.=s|GENRE=m|CAS=n
vet	aler	VERcjg	MODE=ind|TEMPS=pst|PERS.=3|NOMB.=s
mostier	mostier	NOMcom	NOMB.=s|GENRE=m|CAS=r
orer	orer2	VERinf	MORPH=empty
mars	marc1	NOMcom	NOMB.=p|GENRE=m|CAS=r
argent	argent	NOMcom	NOMB.=s|GENRE=m|CAS=r
a	avoir	VERcjg	MODE=ind|TEMPS=pst|PERS.=3|NOMB.=s
mis	metre2	VERppe	NOMB.=s|GENRE=m|CAS=r
autel	autel2	NOMcom	NOMB.=s|GENRE=m|CAS=r
pailes	paile	NOMcom	NOMB.=p|GENRE=m|CAS=r
tapiz	tapiz	NOMcom	NOMB.=p|GENRE=m|CAS=r
roez	röer2	VERppe	NOMB.=s|GENRE=m|CAS=r
Grant	grant	ADJqua	NOMB.=s|GENRE=f|CAS=n|DEGRE=p
est	estre1	VERcjg	MODE=ind|TEMPS=pst|PERS.=3|NOMB.=s
offrende	ofrende	NOMcom	NOMB.=s|GENRE=f|CAS=n
prince	prince	NOMcom	NOMB.=p|GENRE=m|CAS=n
ont	avoir	VERcjg	MODE=ind|TEMPS=pst|PERS.=3|NOMB.=p
doné	doner	VERppe	NOMB.=s|GENRE=m|CAS=r
ot	avoir	VERcjg	MODE=ind|TEMPS=psp|PERS.=3|NOMB.=s
per	per	NOMcom	NOMB.=s|GENRE=f|CAS=r
mostier	mostier	NOMcom	NOMB.=s|GENRE=m|CAS=r
ist	issir	VERcjg	MODE=ind|TEMPS=pst|PERS.=3|NOMB.=s
cort	cort2	ADJqua	NOMB.=s|GENRE=m|CAS=r|DEGRE=p
nés	nase	NOMcom	NOMB.=s|GENRE=m|CAS=r
tenoient	tenir1	VERcjg	MODE=ind|TEMPS=ipf|PERS.=3|NOMB.=p
plet	plait	NOMcom	NOMB.=s|GENRE=m|CAS=r
concile	concile	NOMcom	NOMB.=s|GENRE=m|CAS=r
assenbloient	assembler	VERcjg	MODE=ind|TEMPS=ipf|PERS.=3|NOMB.=p
vile	vile	NOMcom	NOMB.=s|GENRE=f|CAS=r
vient	venir	VERcjg	MODE=ind|TEMPS=pst|PERS.=3|NOMB.=s
place	place	NOMcom	NOMB.=s|GENRE=f|CAS=r
perron	perron	NOMcom	NOMB.=s|GENRE=m|CAS=r
ot	avoir	VERcjg	MODE=ind|TEMPS=psp|PERS.=3|NOMB.=s
entaillié	entaillier	VERppe	NOMB.=s|GENRE=m|CAS=n
vert	vert	ADJqua	NOMB.=s|GENRE=m|CAS=r|DEGRE=p
marbre	marbre	NOMcom	NOMB.=s|GENRE=m|CAS=r
descendi	descendre	VERcjg	MODE=ind|TEMPS=psp|PERS.=3|NOMB.=s
prist	prendre	VERcjg	MODE=ind|TEMPS=psp|PERS.=3|NOMB.=s
borse	borse	NOMcom	NOMB.=s|GENRE=f|CAS=r
deniers	denier	NOMcom	NOMB.=p|GENRE=m|CAS=r
deslace	deslacier	VERcjg	MODE=ind|TEMPS=pst|PERS.=3|NOMB.=s
grant	grant	ADJqua	NOMB.=s|GENRE=f|CAS=r|DEGRE=p
poigniee	poigniee	NOMcom	NOMB.=s|GENRE=f|CAS=r
bons	bon	ADJqua	NOMB.=p|GENRE=m|CAS=r|DEGRE=p
deniers	denier	NOMcom	NOMB.=p|GENRE=m|CAS=r
sache	sachier2	VERcjg	MODE=ind|TEMPS=pst|PERS.=3|NOMB.=s
demande	demander	VERcjg	MODE=ind|TEMPS=pst|PERS.=3|NOMB.=s
prent	prendre	VERcjg	MODE=ind|TEMPS=pst|PERS.=3|NOMB.=s
guionnache	guionage	NOMcom	NOMB.=s|GENRE=m|CAS=r
velt	voloir	VERcjg	MODE=ind|TEMPS=pst|PERS.=3|NOMB.=s
riens	rien	NOMcom	NOMB.=s|GENRE=f|CAS=r
mal	mal1	NOMcom	NOMB.=s|GENRE=m|CAS=r
face	faire	VERcjg	MODE=sub|TEMPS=pst|PERS.=3|NOMB.=s
Dient	dire	VERcjg	MODE=ind|TEMPS=pst|PERS.=3|NOMB.=p
paien	paien	NOMcom	NOMB.=p|GENRE=m|CAS=n
avroiz	avoir	VERcjg	MODE=ind|TEMPS=fut|PERS.=2|NOMB.=p
garde	garde	NOMcom	NOMB.=s|GENRE=f|CAS=r
a	avoir	VERcjg	MODE=ind|TEMPS=pst|PERS.=3|NOMB.=s
home	ome	NOMcom	NOMB.=s|GENRE=m|CAS=r
riche	riche	ADJqua	NOMB.=s|GENRE=m|CAS=r|DEGRE=p
lignage	lignage	NOMcom	NOMB.=s|GENRE=m|CAS=r
disoit	dire	VERcjg	MODE=ind|TEMPS=ipf|PERS.=3|NOMB.=s
orgueill	orgueil	NOMcom	NOMB.=s|GENRE=m|CAS=r
outrage	outrage	NOMcom	NOMB.=s|GENRE=m|CAS=r
pendist	pendre	VERcjg	MODE=sub|TEMPS=ipf|PERS.=3|NOMB.=s
gueule	gole	NOMcom	NOMB.=s|GENRE=f|CAS=r
arbre	arbre	NOMcom	NOMB.=s|GENRE=m|CAS=r
vont	aler	VERcjg	MODE=ind|TEMPS=pst|PERS.=3|NOMB.=p
parlant	parler	VERppa	NOMB.=x|GENRE=x|CAS=x
conte	conte1	NOMcom	NOMB.=s|GENRE=m|CAS=r
pledoiant	plaidoiier	VERppa	NOMB.=x|GENRE=x|CAS=x
puis	pöoir	VERcjg	MODE=ind|TEMPS=pst|PERS.=1|NOMB.=s
prendre	prendre	VERinf	MORPH=empty
honte	honte	NOMcom	NOMB.=s|GENRE=f|CAS=r
vit	vivre1	VERcjg	MODE=ind|TEMPS=psp|PERS.=3|NOMB.=s
cors	cors1	NOMcom	NOMB.=s|GENRE=m|CAS=n
saches	savoir	VERcjg	MODE=imp|PERS.=2|NOMB.=s
voir	voir	ADJqua	NOMB.=s|GENRE=m|CAS=r|DEGRE=p
venuz	venir	VERppe	NOMB.=s|GENRE=m|CAS=n
es	estre1	VERcjg	MODE=ind|TEMPS=pst|PERS.=2|NOMB.=s
mort	mort	NOMcom	NOMB.=s|GENRE=f|CAS=r
dit	dire	VERcjg	MODE=ind|TEMPS=pst|PERS.=3|NOMB.=s
chiere	chiere	NOMcom	NOMB.=s|GENRE=f|CAS=r
hardie	hardi	ADJqua	NOMB.=s|GENRE=f|CAS=r|DEGRE=p
fel	felon	ADJqua	NOMB.=s|GENRE=m|CAS=n|DEGRE=p
rois	roi2	NOMcom	NOMB.=s|GENRE=m|CAS=n
maldie	maudire	VERcjg	MODE=sub|TEMPS=pst|PERS.=3|NOMB.=s
creoies	croire	VERcjg	MODE=ind|TEMPS=ipf|PERS.=2|NOMB.=s
filz	fil2	NOMcom	NOMB.=s|GENRE=m|CAS=r
saches	savoir	VERcjg	MODE=imp|PERS.=2|NOMB.=s
voir	voir	ADJqua	NOMB.=s|GENRE=m|CAS=r|DEGRE=p
ame	ame	NOMcom	NOMB.=s|GENRE=f|CAS=n
sera	estre1	VERcjg	MODE=ind|TEMPS=fut|PERS.=3|NOMB.=s
garie	garir	VERppe	NOMB.=s|GENRE=f|CAS=n
fes	faire	VERcjg	MODE=ind|TEMPS=pst|PERS.=2|NOMB.=s
jur	jurer	VERcjg	MODE=ind|TEMPS=pst|PERS.=1|NOMB.=s
afie	afïer	VERcjg	MODE=ind|TEMPS=pst|PERS.=1|NOMB.=s
teste	teste	NOMcom	NOMB.=s|GENRE=f|CAS=r
poteras	porter	VERcjg	MODE=ind|TEMPS=fut|PERS.=2|NOMB.=s
valt	valoir	VERcjg	MODE=ind|TEMPS=pst|PERS.=3|NOMB.=s
alie	alie	NOMcom	NOMB.=s|GENRE=f|CAS=r
dist	dire	VERcjg	MODE=ind|TEMPS=psp|PERS.=3|NOMB.=s
sai	savoir	VERcjg	MODE=ind|TEMPS=pst|PERS.=1|NOMB.=s
die	dire	VERcjg	MODE=sub|TEMPS=pst|PERS.=1|NOMB.=s
ferai	faire	VERcjg	MODE=ind|TEMPS=fut|PERS.=1|NOMB.=s
cuers	cuer2	NOMcom	NOMB.=s|GENRE=m|CAS=n
otrie	otroiier	VERcjg	MODE=ind|TEMPS=pst|PERS.=3|NOMB.=s
ferai	faire	VERcjg	MODE=ind|TEMPS=fut|PERS.=1|NOMB.=s
croie	croire	VERcjg	MODE=sub|TEMPS=pst|PERS.=1|NOMB.=s
loi	loi3	NOMcom	NOMB.=s|GENRE=f|CAS=r
deguerpisse	deguerpir	VERcjg	MODE=sub|TEMPS=pst|PERS.=1|NOMB.=s
Ot	öir	VERcjg	MODE=ind|TEMPS=pst|PERS.=3|NOMB.=s
enrage	enragier	VERcjg	MODE=ind|TEMPS=pst|PERS.=3|NOMB.=s
ire	ire	NOMcom	NOMB.=s|GENRE=f|CAS=r
degrez	degré	NOMcom	NOMB.=p|GENRE=m|CAS=r
traïne	träiner	VERcjg	MODE=ind|TEMPS=pst|PERS.=3|NOMB.=s
est	estre1	VERcjg	MODE=ind|TEMPS=pst|PERS.=3|NOMB.=s
garde	garde	NOMcom	NOMB.=s|GENRE=f|CAS=r
donés	doner	VERppe	NOMB.=s|GENRE=m|CAS=n
pence	penser	VERcjg	MODE=ind|TEMPS=pst|PERS.=3|NOMB.=s
vient	venir	VERcjg	MODE=ind|TEMPS=pst|PERS.=3|NOMB.=s
jouster	joster	VERinf	MORPH=empty
gent	gent1	NOMcom	NOMB.=s|GENRE=f|CAS=r
apellet	apeler	VERcjg	MODE=ind|TEMPS=pst|PERS.=3|NOMB.=s
Veés	vëoir	VERcjg	MODE=imp|PERS.=2|NOMB.=p
vient	venir	VERcjg	MODE=ind|TEMPS=pst|PERS.=3|NOMB.=s
conreés	conrëer	VERppe	NOMB.=s|GENRE=m|CAS=n
vient	venir	VERcjg	MODE=ind|TEMPS=pst|PERS.=3|NOMB.=s
armés	armer	VERppe	NOMB.=s|GENRE=m|CAS=n
ocit	ocire	VERcjg	MODE=ind|TEMPS=pst|PERS.=3|NOMB.=s
alés	aler	VERcjg	MODE=ind|TEMPS=pst|PERS.=2|NOMB.=p
est	estre1	VERcjg	MODE=ind|TEMPS=pst|PERS.=3|NOMB.=s
nés	naistre	VERppe	NOMB.=s|GENRE=m|CAS=n
païs	päis	NOMcom	NOMB.=s|GENRE=m|CAS=r
avriés	avoir	VERcjg	MODE=con|PERS.=2|NOMB.=p
demorer	demorer	NOMcom	NOMB.=s|GENRE=m|CAS=r
respondent	respondre1	VERcjg	MODE=ind|TEMPS=pst|PERS.=3|NOMB.=p
volenté	volenté	NOMcom	NOMB.=s|GENRE=f|CAS=r
et	estre1	VERcjg	MODE=ind|TEMPS=pst|PERS.=3|NOMB.=s
galopés	galoper	VERppe	NOMB.=s|GENRE=m|CAS=n
vint	venir	VERcjg	MODE=ind|TEMPS=psp|PERS.=3|NOMB.=s
est	estre1	VERcjg	MODE=ind|TEMPS=pst|PERS.=3|NOMB.=s
escriés	escrïer	VERppe	NOMB.=s|GENRE=m|CAS=n
iers	estre1	VERcjg	MODE=ind|TEMPS=pst|PERS.=2|NOMB.=s
va	aler	VERcjg	MODE=imp|PERS.=2|NOMB.=s
Garde	garde	NOMcom	MODE=imp|PERS.=2|NOMB.=s
celer	celer1	VERinf	MORPH=empty
Iers	estre1	VERcjg	MODE=ind|TEMPS=pst|PERS.=2|NOMB.=s
messaiges	message2	NOMcom	NOMB.=s|GENRE=m|CAS=n
viens	venir	VERcjg	MODE=ind|TEMPS=pst|PERS.=2|NOMB.=s
parler	parler	VERinf	MORPH=empty
dist	dire	VERcjg	MODE=ind|TEMPS=psp|PERS.=3|NOMB.=s
vains	venir	VERcjg	MODE=ind|TEMPS=pst|PERS.=1|NOMB.=s
joster	joster	VERinf	MORPH=empty
paiens	paien	NOMcom	NOMB.=s|GENRE=m|CAS=n
oit	öir	VERcjg	MODE=ind|TEMPS=psp|PERS.=3|NOMB.=s
fu	estre1	VERcjg	MODE=ind|TEMPS=psp|PERS.=3|NOMB.=s
fiers	fier	ADJqua	NOMB.=s|GENRE=m|CAS=n|DEGRE=p
maffé	maufé	NOMcom	NOMB.=s|GENRE=m|CAS=r
sont	estre1	VERcjg	MODE=ind|TEMPS=pst|PERS.=3|NOMB.=p
glotons	gloton	ADJqua	NOMB.=p|GENRE=m|CAS=n|DEGRE=p
mavais	mauvais	ADJqua	NOMB.=p|GENRE=m|CAS=n|DEGRE=p
braiz	braz	NOMcom	NOMB.=s|GENRE=m|CAS=r
braz	braz	NOMcom	NOMB.=s|GENRE=m|CAS=r
sont	estre1	VERcjg	MODE=ind|TEMPS=pst|PERS.=3|NOMB.=p
pris	prendre	VERppe	NOMB.=p|GENRE=m|CAS=n
par	part1	NOMcom	NOMB.=s|GENRE=f|CAS=r
son	estre1	VERcjg	MODE=ind|TEMPS=pst|PERS.=3|NOMB.=p
traiz	traire	VERppe	NOMB.=p|GENRE=m|CAS=n
Frere	frere	NOMcom	NOMB.=s|GENRE=m|CAS=n
dit	dire	VERcjg	MODE=ind|TEMPS=pst|PERS.=3|NOMB.=s
riens	rien	NOMcom	NOMB.=s|GENRE=f|CAS=r
dirai	dire	VERcjg	MODE=ind|TEMPS=fut|PERS.=1|NOMB.=s
ein	amer1	VERcjg	MODE=ind|TEMPS=pst|PERS.=1|NOMB.=s
soudoier	soudoiier1	NOMcom	NOMB.=s|GENRE=m|CAS=r
errai	häir	VERcjg	MODE=ind|TEMPS=fut|PERS.=1|NOMB.=s
Larges	large	ADJqua	NOMB.=s|GENRE=m|CAS=n|DEGRE=p
est	estre1	VERcjg	MODE=ind|TEMPS=pst|PERS.=3|NOMB.=s
doner	doner	VERinf	MORPH=empty
varsal	vassal	ADJqua	NOMB.=s|GENRE=m|CAS=n|DEGRE=p
cortois	cortois	ADJqua	NOMB.=s|GENRE=m|CAS=n|DEGRE=p
home	ome	NOMcom	NOMB.=p|GENRE=m|CAS=n
servent	servir	VERcjg	MODE=ind|TEMPS=pst|PERS.=3|NOMB.=p
bons	bon	ADJqua	NOMB.=s|GENRE=m|CAS=n|DEGRE=p
mauvais	mauvais	ADJqua	NOMB.=s|GENRE=m|CAS=n|DEGRE=p
prant	prendre	VERcjg	MODE=ind|TEMPS=pst|PERS.=3|NOMB.=s
serour	seror	NOMcom	NOMB.=s|GENRE=f|CAS=r
chaüz	chëoir	VERppe	NOMB.=p|GENRE=m|CAS=n
sumes	estre1	VERcjg	MODE=ind|TEMPS=pst|PERS.=1|NOMB.=p
fais	fais	NOMcom	NOMB.=s|GENRE=m|CAS=r
Aulons	aler	VERcjg	MODE=imp|PERS.=1|NOMB.=p
amiraur	amiral	NOMcom	NOMB.=s|GENRE=m|CAS=r
batison	bastir	VERcjg	MODE=imp|PERS.=1|NOMB.=p
plait	plait	NOMcom	NOMB.=s|GENRE=m|CAS=r
chartre	chartre1	NOMcom	NOMB.=s|GENRE=f|CAS=r
giet	jeter	VERcjg	MODE=sub|TEMPS=pst|PERS.=3|NOMB.=s
itrai	issir	VERcjg	MODE=ind|TEMPS=fut|PERS.=3|NOMB.=s
Frere	frere	NOMcom	NOMB.=s|GENRE=m|CAS=n
dit	dire	VERcjg	MODE=ind|TEMPS=pst|PERS.=3|NOMB.=s
faudrai	falir	VERcjg	MODE=ind|TEMPS=fut|PERS.=1|NOMB.=s
puis	pöoir	VERcjg	MODE=ind|TEMPS=pst|PERS.=1|NOMB.=s
serour	seror	NOMcom	NOMB.=s|GENRE=f|CAS=r
pandre	pendre	VERinf	MORPH=empty
feu	feu	NOMcom	NOMB.=s|GENRE=m|CAS=r
ardrai	ardre	VERcjg	MODE=ind|TEMPS=fut|PERS.=1|NOMB.=s
vam	vent	NOMcom	NOMB.=s|GENRE=m|CAS=r
ancroerai	encröer	VERcjg	MODE=ind|TEMPS=fut|PERS.=3|NOMB.=s
Seignor	seignor	NOMcom	NOMB.=s|GENRE=m|CAS=n
escoutez	escouter	VERcjg	MODE=imp|PERS.=2|NOMB.=p
faites	faire	VERcjg	MODE=imp|PERS.=2|NOMB.=p
paiz	pais	NOMcom	NOMB.=s|GENRE=f|CAS=r
oez	öir	VERcjg	MODE=imp|PERS.=2|NOMB.=p
faite	faire	VERppe	NOMB.=s|GENRE=f|CAS=n
traïsom	träison	NOMcom	NOMB.=s|GENRE=f|CAS=n
fut	estre1	VERcjg	MODE=ind|TEMPS=psp|PERS.=3|NOMB.=s
iert	estre1	VERcjg	MODE=ind|TEMPS=fut|PERS.=3|NOMB.=s
ot	avoir	VERcjg	MODE=ind|TEMPS=psp|PERS.=3|NOMB.=s
loier	loiier	NOMcom	NOMB.=s|GENRE=m|CAS=r
fiz	fil2	NOMcom	NOMB.=s|GENRE=m|CAS=n
ocit	ocire	VERcjg	MODE=ind|TEMPS=psp|PERS.=3|NOMB.=s
ai	avoir	VERcjg	MODE=ind|TEMPS=pst|PERS.=3|NOMB.=s
conquise	conquerre	VERppe	NOMB.=s|GENRE=f|CAS=r
file	fille	NOMcom	NOMB.=s|GENRE=f|CAS=r
vis	vis1	NOMcom	NOMB.=s|GENRE=m|CAS=r
fier	fier	ADJqua	NOMB.=s|GENRE=m|CAS=r|DEGRE=p
doinea	deignier	VERcjg	MODE=ind|TEMPS=psp|PERS.=3|NOMB.=s
panre	prendre	VERinf	MORPH=empty
moilier	moillier1	NOMcom	NOMB.=s|GENRE=f|CAS=r
vot	voloir	VERcjg	MODE=ind|TEMPS=psp|PERS.=3|NOMB.=s
doner	doner	VERinf	MORPH=empty
escuier	escuier2	NOMcom	NOMB.=s|GENRE=m|CAS=r
vosimes	voloir	VERcjg	MODE=ind|TEMPS=psp|PERS.=1|NOMB.=p
plait	plait	NOMcom	NOMB.=s|GENRE=m|CAS=r
graer	grëer	VERinf	MORPH=empty
outroiier	otroiier	VERinf	MORPH=empty
deu	dieu	NOMcom	NOMB.=s|GENRE=m|CAS=r
venos	venir	VERcjg	MODE=ind|TEMPS=pst|PERS.=1|NOMB.=p
avoier	avoiier	VERinf	MORPH=empty
Barons	baron	NOMcom	NOMB.=s|GENRE=m|CAS=n
dit	dire	VERcjg	MODE=ind|TEMPS=pst|PERS.=3|NOMB.=s
amiraus	amiral	NOMcom	NOMB.=s|GENRE=m|CAS=n
faites	faire	VERcjg	MODE=ind|TEMPS=pst|PERS.=2|NOMB.=p
prisier	prisier	VERinf	MORPH=empty
perdras	perdre	VERcjg	MODE=ind|TEMPS=fut|PERS.=2|NOMB.=s
terres	terre	NOMcom	NOMB.=p|GENRE=f|CAS=r
vailesant	valoir	VERppa	NOMB.=s|GENRE=m|CAS=r
donier	denier	NOMcom	NOMB.=s|GENRE=m|CAS=r
aurez	avoir	VERcjg	MODE=ind|TEMPS=fut|PERS.=2|NOMB.=p
chatais	chastel	NOMcom	NOMB.=p|GENRE=m|CAS=r
fier	fief	NOMcom	NOMB.=s|GENRE=m|CAS=r
amiraux	amiral	NOMcom	NOMB.=s|GENRE=m|CAS=n
apale	apeler	VERcjg	MODE=ind|TEMPS=pst|PERS.=3|NOMB.=s
desfaé	desfäé	ADJqua	NOMB.=s|GENRE=m|CAS=r|DEGRE=p
Faite	faire	VERcjg	MODE=imp|PERS.=2|NOMB.=s
aporter	aporter	VERinf	MORPH=empty
respondirent	respondre1	VERcjg	MODE=ind|TEMPS=psp|PERS.=3|NOMB.=p
conmandez	comander	VERcjg	MODE=ind|TEMPS=pst|PERS.=2|NOMB.=p
colomes	colombe2	NOMcom	NOMB.=p|GENRE=f|CAS=r
firent	faire	VERcjg	MODE=ind|TEMPS=psp|PERS.=3|NOMB.=p
amener	amener	VERinf	MORPH=empty
vilains	vilain	NOMcom	NOMB.=s|GENRE=m|CAS=n
fut	estre1	VERcjg	MODE=ind|TEMPS=psp|PERS.=3|NOMB.=s
gros	gros	ADJqua	NOMB.=s|GENRE=m|CAS=n|DEGRE=p
parfonz	parfont	ADJqua	NOMB.=s|GENRE=m|CAS=n|DEGRE=p
carré	carré	ADJqua	NOMB.=s|GENRE=m|CAS=n|DEGRE=p
fin	fin2	ADJqua	NOMB.=s|GENRE=m|CAS=r|DEGRE=p
or	or1	NOMcom	NOMB.=s|GENRE=m|CAS=r
fut	estre1	VERcjg	MODE=ind|TEMPS=psp|PERS.=3|NOMB.=s
forgiez	forgier	VERppe	NOMB.=s|GENRE=m|CAS=n
fondez	fonder2	VERppe	NOMB.=s|GENRE=m|CAS=n
ot	avoir	VERcjg	MODE=ind|TEMPS=psp|PERS.=3|NOMB.=s
mort	morir	VERppe	NOMB.=s|GENRE=m|CAS=r
jut	jesir	VERcjg	MODE=ind|TEMPS=psp|PERS.=3|NOMB.=s
place	place	NOMcom	NOMB.=s|GENRE=f|CAS=r
paien	paien	NOMcom	NOMB.=p|GENRE=m|CAS=n
esgardent	esgarder	VERcjg	MODE=ind|TEMPS=pst|PERS.=3|NOMB.=p
dessendent	descendre	VERcjg	MODE=ind|TEMPS=pst|PERS.=3|NOMB.=p
angarde	angarde	NOMcom	NOMB.=s|GENRE=f|CAS=r
sont	estre1	VERcjg	MODE=ind|TEMPS=pst|PERS.=3|NOMB.=p
eslaissiét	eslaissier	VERppe	NOMB.=p|GENRE=m|CAS=n
felon	felon	NOMcom	NOMB.=p|GENRE=m|CAS=n
mescreable	mescrëable	ADJqua	NOMB.=p|GENRE=m|CAS=n|DEGRE=p
ber	baron	NOMcom	NOMB.=s|GENRE=m|CAS=n
desfent	defendre	VERcjg	MODE=ind|TEMPS=pst|PERS.=3|NOMB.=s
ait	avoir	VERcjg	MODE=sub|TEMPS=pst|PERS.=3|NOMB.=s
garde	garde	NOMcom	NOMB.=s|GENRE=f|CAS=r
encontre	encontrer	VERcjg	MODE=ind|TEMPS=pst|PERS.=3|NOMB.=s
ot	avoir	VERcjg	MODE=ind|TEMPS=psp|PERS.=3|NOMB.=s
talent	talent	NOMcom	NOMB.=s|GENRE=m|CAS=r
oir	öir	VERinf	MORPH=empty
fable	fable	NOMcom	NOMB.=s|GENRE=f|CAS=r
abati	abatre	VERcjg	MODE=ind|TEMPS=psp|PERS.=3|NOMB.=s
terre	terre	NOMcom	NOMB.=s|GENRE=f|CAS=r
raine	raine	NOMcom	NOMB.=s|GENRE=f|CAS=r
plate	plat	ADJqua	NOMB.=s|GENRE=f|CAS=r|DEGRE=p
tornent	torner	VERcjg	MODE=ind|TEMPS=pst|PERS.=3|NOMB.=p
fuie	fuie	NOMcom	NOMB.=s|GENRE=f|CAS=r
cache	chacier	VERcjg	MODE=ind|TEMPS=pst|PERS.=3|NOMB.=s
encauche	enchaucier	VERcjg	MODE=ind|TEMPS=pst|PERS.=3|NOMB.=s
mort	mort	NOMcom	NOMB.=s|GENRE=f|CAS=r
manace	menacier	VERcjg	MODE=ind|TEMPS=pst|PERS.=3|NOMB.=s
vait	aler	VERcjg	MODE=ind|TEMPS=pst|PERS.=3|NOMB.=s
ferir	ferir	VERinf	MORPH=empty
doree	dorer	VERppe	NOMB.=s|GENRE=f|CAS=r
targe	targe1	NOMcom	NOMB.=s|GENRE=f|CAS=r
boucle	bocle	NOMcom	NOMB.=s|GENRE=f|CAS=r
or	or1	NOMcom	NOMB.=s|GENRE=m|CAS=r
a	avoir	VERcjg	MODE=ind|TEMPS=pst|PERS.=3|NOMB.=s
percie	percier	VERppe	NOMB.=s|GENRE=f|CAS=r
quasse	casser	VERcjg	MODE=ind|TEMPS=pst|PERS.=3|NOMB.=s
fu	estre1	VERcjg	MODE=ind|TEMPS=psp|PERS.=3|NOMB.=s
boin	bon	ADJqua	NOMB.=s|GENRE=m|CAS=n|DEGRE=p
auberc	hauberc	NOMcom	NOMB.=s|GENRE=m|CAS=n
rompi	rompre	VERcjg	MODE=ind|TEMPS=psp|PERS.=3|NOMB.=s
maille	maille	NOMcom	NOMB.=s|GENRE=f|CAS=r
vasal	vassal	NOMcom	NOMB.=p|GENRE=m|CAS=n
sont	estre1	VERcjg	MODE=ind|TEMPS=pst|PERS.=3|NOMB.=p
preu	pro	ADJqua	NOMB.=p|GENRE=m|CAS=n|DEGRE=p
entrabatent	entr'abatre	VERcjg	MODE=ind|TEMPS=pst|PERS.=3|NOMB.=p
passe	passer1	VERcjg	MODE=ind|TEMPS=pst|PERS.=3|NOMB.=s
toli	tolir	VERcjg	MODE=ind|TEMPS=psp|PERS.=3|NOMB.=s
hanste	hanste	NOMcom	NOMB.=s|GENRE=f|CAS=r
pré	pré	NOMcom	NOMB.=s|GENRE=m|CAS=r
jete	jeter	VERcjg	MODE=ind|TEMPS=pst|PERS.=3|NOMB.=s
a	avoir	VERcjg	MODE=ind|TEMPS=pst|PERS.=3|NOMB.=s
espee	espee	NOMcom	NOMB.=s|GENRE=f|CAS=r
traite	traire	VERppe	NOMB.=s|GENRE=f|CAS=r
ai	avoir	VERcjg	MODE=ind|TEMPS=pst|PERS.=3|NOMB.=s
mandé	mander	VERppe	NOMB.=s|GENRE=m|CAS=r
riche	riche	ADJqua	NOMB.=s|GENRE=m|CAS=r|DEGRE=p
roi	roi2	NOMcom	NOMB.=s|GENRE=m|CAS=r
secor	secors	NOMcom	NOMB.=s|GENRE=m|CAS=r
ajut	ajoster	VERcjg	MODE=sub|TEMPS=pst|PERS.=3|NOMB.=s
amena	amener	VERcjg	MODE=ind|TEMPS=psp|PERS.=3|NOMB.=s
escus	escu	NOMcom	NOMB.=p|GENRE=m|CAS=r
est	estre1	VERcjg	MODE=ind|TEMPS=pst|PERS.=3|NOMB.=s
secor	secors	NOMcom	NOMB.=s|GENRE=m|CAS=r
venus	venir	VERppe	NOMB.=s|GENRE=m|CAS=n
a	avoir	VERcjg	MODE=ind|TEMPS=pst|PERS.=3|NOMB.=s
asamblé	assembler	VERppe	NOMB.=s|GENRE=m|CAS=r
sont	estre1	VERcjg	MODE=ind|TEMPS=pst|PERS.=3|NOMB.=p
lairons	laissier	VERcjg	MODE=ind|TEMPS=fut|PERS.=1|NOMB.=p
cor	cort2	ADJqua	NOMB.=s|GENRE=m|CAS=r|DEGRE=p
nés	nase	NOMcom	NOMB.=s|GENRE=m|CAS=r
menbru	membru1	ADJqua	NOMB.=s|GENRE=m|CAS=r|DEGRE=p
dirons	dire	VERcjg	MODE=ind|TEMPS=fut|PERS.=1|NOMB.=p
fiere	fier	ADJqua	NOMB.=s|GENRE=f|CAS=r|DEGRE=p
vertu	vertu	NOMcom	NOMB.=s|GENRE=f|CAS=r
mainent	mener	VERcjg	MODE=ind|TEMPS=pst|PERS.=3|NOMB.=p
quiver	culvert	NOMcom	NOMB.=p|GENRE=m|CAS=n
mescreu	mescroire	VERppe	NOMB.=p|GENRE=m|CAS=n
Dist	dire	VERcjg	MODE=ind|TEMPS=pst|PERS.=3|NOMB.=s
est	estre1	VERcjg	MODE=ind|TEMPS=pst|PERS.=3|NOMB.=s
avenu	avenir	VERppe	NOMB.=s|GENRE=m|CAS=n
sont	estre1	VERcjg	MODE=ind|TEMPS=pst|PERS.=3|NOMB.=p
escapé	eschaper	VERppe	NOMB.=p|GENRE=m|CAS=n
ont	avoir	VERcjg	MODE=ind|TEMPS=pst|PERS.=3|NOMB.=p
vertu	vertu	NOMcom	NOMB.=s|GENRE=f|CAS=r
vauront	voloir	VERcjg	MODE=ind|TEMPS=fut|PERS.=3|NOMB.=p
repairier	repairier	VERinf	MORPH=empty
jors	jor	NOMcom	NOMB.=p|GENRE=m|CAS=r
averont	avoir	VERcjg	MODE=ind|TEMPS=fut|PERS.=3|NOMB.=p
compaigne	compagnie	NOMcom	NOMB.=s|GENRE=f|CAS=r
escus	escu	NOMcom	NOMB.=p|GENRE=m|CAS=r
dura	durer	VERcjg	MODE=ind|TEMPS=fut|PERS.=3|NOMB.=s
ont	avoir	VERcjg	MODE=ind|TEMPS=pst|PERS.=3|NOMB.=p
vertu	vertu	NOMcom	NOMB.=s|GENRE=f|CAS=r
issons	issir	VERcjg	MODE=imp|PERS.=1|NOMB.=p
terre	terre	NOMcom	NOMB.=s|GENRE=f|CAS=r
soions	estre1	VERcjg	MODE=sub|TEMPS=pst|PERS.=1|NOMB.=p
veu	vëoir	VERppe	NOMB.=p|GENRE=m|CAS=n
ont	avoir	VERcjg	MODE=ind|TEMPS=pst|PERS.=3|NOMB.=p
respondu	respondre1	VERppe	NOMB.=s|GENRE=m|CAS=r
consaus	conseil	NOMcom	NOMB.=s|GENRE=m|CAS=n
ert	estre1	VERcjg	MODE=ind|TEMPS=fut|PERS.=3|NOMB.=s
creu	croire	VERppe	NOMB.=s|GENRE=m|CAS=n
riens	rien	NOMcom	NOMB.=s|GENRE=f|CAS=r
tere	terre	NOMcom	NOMB.=s|GENRE=f|CAS=r
arce	arche2	NOMcom	NOMB.=s|GENRE=x|CAS=r
ai	avoir	VERcjg	MODE=ind|TEMPS=pst|PERS.=1|NOMB.=s
fait	faire	VERppe	NOMB.=s|GENRE=m|CAS=r
canbre	chambre1	NOMcom	NOMB.=s|GENRE=f|CAS=r
fin	fin2	ADJqua	NOMB.=s|GENRE=m|CAS=r|DEGRE=p
or	or1	NOMcom	NOMB.=s|GENRE=m|CAS=r
pointurer	peinturer	VERinf	MORPH=empty
a	avoir	VERcjg	MODE=ind|TEMPS=pst|PERS.=3|NOMB.=s
richece	richece	NOMcom	NOMB.=s|GENRE=f|CAS=r
gardés	garder	VERcjg	MODE=ind|TEMPS=pst|PERS.=2|NOMB.=p
chevaliers	chevalier	NOMcom	NOMB.=p|GENRE=m|CAS=r
manteus	mantel	NOMcom	NOMB.=p|GENRE=m|CAS=r
engoulés	engoler	VERppe	NOMB.=p|GENRE=m|CAS=r
sont	estre1	VERcjg	MODE=ind|TEMPS=pst|PERS.=3|NOMB.=p
home	ome	NOMcom	NOMB.=p|GENRE=m|CAS=n
pere	pere	NOMcom	NOMB.=s|GENRE=m|CAS=r
quier	querre	VERcjg	MODE=ind|TEMPS=pst|PERS.=1|NOMB.=s
cheler	celer1	VERinf	MORPH=empty
Saint	saint	ADJqua	NOMB.=s|GENRE=m|CAS=r|DEGRE=p
fait	faire	VERcjg	MODE=ind|TEMPS=pst|PERS.=3|NOMB.=s
loer	löer1	VERinf	MORPH=empty
quide	cuidier1	VERcjg	MODE=ind|TEMPS=pst|PERS.=3|NOMB.=s
amiraus	amiral	NOMcom	NOMB.=s|GENRE=m|CAS=n
soient	estre1	VERcjg	MODE=sub|TEMPS=pst|PERS.=3|NOMB.=p
mort	morir	VERppe	NOMB.=p|GENRE=m|CAS=n
geté	jeter	VERppe	NOMB.=p|GENRE=m|CAS=n
fac	faire	VERcjg	MODE=ind|TEMPS=pst|PERS.=1|NOMB.=s
cambre	chambre1	NOMcom	NOMB.=s|GENRE=f|CAS=r
garder	garder	VERinf	MORPH=empty
hubers	hauberc	NOMcom	NOMB.=p|GENRE=m|CAS=r
elmes	heaume	NOMcom	NOMB.=p|GENRE=m|CAS=r
escus	escu	NOMcom	NOMB.=p|GENRE=m|CAS=r
fors	fort	ADJqua	NOMB.=s|GENRE=m|CAS=r|DEGRE=p
lés	lé	ADJqua	NOMB.=p|GENRE=m|CAS=r|DEGRE=p
tient	tenir1	VERcjg	MODE=ind|TEMPS=pst|PERS.=3|NOMB.=s
amie	ami	NOMcom	NOMB.=s|GENRE=f|CAS=r
ermin	ermin	NOMcom	NOMB.=s|GENRE=m|CAS=r
engoulé	engoler	VERppe	NOMB.=s|GENRE=m|CAS=r
est	estre1	VERcjg	MODE=ind|TEMPS=pst|PERS.=3|NOMB.=s
fille	fille	NOMcom	NOMB.=s|GENRE=f|CAS=n
conte	conte1	NOMcom	NOMB.=s|GENRE=m|CAS=r
duc	duc2	NOMcom	NOMB.=s|GENRE=m|CAS=r
amiel	amiral	NOMcom	NOMB.=s|GENRE=m|CAS=r
a	avoir	VERcjg	MODE=ind|TEMPS=pst|PERS.=3|NOMB.=s
ans	an	NOMcom	NOMB.=p|GENRE=m|CAS=r
passé	passer1	VERppe	NOMB.=s|GENRE=m|CAS=r
vieut	voloir	VERcjg	MODE=ind|TEMPS=pst|PERS.=3|NOMB.=s
baisse	baisier	VERcjg	MODE=ind|TEMPS=pst|PERS.=3|NOMB.=s
aideront	aidier	VERcjg	MODE=ind|TEMPS=fut|PERS.=3|NOMB.=p
mestier	mestier	NOMcom	NOMB.=s|GENRE=m|CAS=r
avés	avoir	VERcjg	MODE=ind|TEMPS=pst|PERS.=2|NOMB.=p
Dame	dame	NOMcom	NOMB.=s|GENRE=f|CAS=n
dist	dire	VERcjg	MODE=ind|TEMPS=psp|PERS.=3|NOMB.=s
merchis	merci	NOMcom	NOMB.=p|GENRE=f|CAS=r
grés	gré2	NOMcom	NOMB.=p|GENRE=m|CAS=r
dist	dire	VERcjg	MODE=ind|TEMPS=psp|PERS.=3|NOMB.=s
aiez	avoir	VERcjg	MODE=imp|PERS.=2|NOMB.=p
cure	cure	NOMcom	NOMB.=s|GENRE=f|CAS=r
chevalcherai	chevauchier	VERcjg	MODE=ind|TEMPS=fut|PERS.=1|NOMB.=s
soir	soir	NOMcom	NOMB.=s|GENRE=m|CAS=r
lune	lune	NOMcom	NOMB.=s|GENRE=f|CAS=r
haubert	hauberc	NOMcom	NOMB.=s|GENRE=m|CAS=r
iert	estre1	VERcjg	MODE=ind|TEMPS=fut|PERS.=3|NOMB.=s
tinte	teindre	VERppe	NOMB.=s|GENRE=f|CAS=n
tointure	teinture	NOMcom	NOMB.=s|GENRE=f|CAS=n
cuit	cuidier1	VERcjg	MODE=ind|TEMPS=pst|PERS.=1|NOMB.=s
panser	penser	VERinf	MORPH=empty
aiue	äie	NOMcom	NOMB.=s|GENRE=f|CAS=r
seis	savoir	VERcjg	MODE=ind|TEMPS=pst|PERS.=2|NOMB.=s
rois	roi2	NOMcom	NOMB.=s|GENRE=m|CAS=n
ai	avoir	VERcjg	MODE=ind|TEMPS=pst|PERS.=1|NOMB.=s
commancié	comencier	VERppe	NOMB.=s|GENRE=m|CAS=r
venoie	venir	VERcjg	MODE=ind|TEMPS=ipf|PERS.=1|NOMB.=s
saint	saint	ADJqua	NOMB.=s|GENRE=m|CAS=r|DEGRE=p
proier	priier	VERinf	MORPH=empty
repairoie	repairier	VERcjg	MODE=ind|TEMPS=ipf|PERS.=1|NOMB.=s
oste	oste	NOMcom	NOMB.=s|GENRE=m|CAS=r
vit	vëoir	VERcjg	MODE=ind|TEMPS=psp|PERS.=3|NOMB.=s
eumes	avoir	VERcjg	MODE=ind|TEMPS=psp|PERS.=1|NOMB.=p
boivre	boivre	VERinf	MORPH=empty
mengier	mangier	VERinf	MORPH=empty
grues	grue	NOMcom	NOMB.=p|GENRE=f|CAS=r
gentes	jante1	NOMcom	NOMB.=p|GENRE=f|CAS=r
malars	malart	NOMcom	NOMB.=p|GENRE=m|CAS=r
ploviers	plovier	NOMcom	NOMB.=p|GENRE=m|CAS=r
plaint	plaindre	VERcjg	MODE=ind|TEMPS=pst|PERS.=3|NOMB.=s
escuier	escuier2	NOMcom	NOMB.=s|GENRE=m|CAS=n
aumes	avoir	VERcjg	MODE=ind|TEMPS=psp|PERS.=1|NOMB.=p
but	boivre	VERppe	NOMB.=s|GENRE=m|CAS=r
mengié	mangier	VERppe	NOMB.=s|GENRE=m|CAS=r
sire	seignor	NOMcom	NOMB.=s|GENRE=m|CAS=n
alait	aler	VERcjg	MODE=ind|TEMPS=psp|PERS.=3|NOMB.=s
bois	bois	NOMcom	NOMB.=s|GENRE=m|CAS=r
esbanoier	esbanoiier	VERinf	MORPH=empty
broches	brachet	NOMcom	NOMB.=p|GENRE=m|CAS=r
loemiers	lïemier	NOMcom	NOMB.=p|GENRE=m|CAS=r
falcons	faucon	NOMcom	NOMB.=p|GENRE=m|CAS=r
esperviers	esprevier	NOMcom	NOMB.=p|GENRE=m|CAS=r
di	dire	VERcjg	MODE=ind|TEMPS=pst|PERS.=1|NOMB.=s
faille	faille3	NOMcom	NOMB.=s|GENRE=f|CAS=r
a	avoir	VERcjg	MODE=ind|TEMPS=pst|PERS.=3|NOMB.=s
malvaise	mauvais	ADJqua	NOMB.=s|GENRE=f|CAS=r|DEGRE=p
fraipaille	frapaille	NOMcom	NOMB.=s|GENRE=f|CAS=r
fais	faire	VERcjg	MODE=ind|TEMPS=pst|PERS.=2|NOMB.=s
proie	proie	NOMcom	NOMB.=s|GENRE=f|CAS=r
chose	chose	NOMcom	NOMB.=s|GENRE=f|CAS=r
vaille	valoir	VERcjg	MODE=sub|TEMPS=pst|PERS.=3|NOMB.=s
sivront	sivre	VERcjg	MODE=ind|TEMPS=fut|PERS.=3|NOMB.=p
sergant	serjant	NOMcom	NOMB.=p|GENRE=m|CAS=n
pietaille	pietaille	NOMcom	NOMB.=s|GENRE=f|CAS=n
fai	faire	VERcjg	MODE=imp|PERS.=2|NOMB.=s
armer	armer	VERinf	MORPH=empty
bataille	bataille	NOMcom	NOMB.=s|GENRE=f|CAS=r
valroient	valoir	VERcjg	MODE=con|PERS.=3|NOMB.=p
vaillant	valoir	VERppa	NOMB.=s|GENRE=f|CAS=r
maaille	mäaille	NOMcom	NOMB.=s|GENRE=f|CAS=r
fuiront	fuir	VERcjg	MODE=ind|TEMPS=fut|PERS.=3|NOMB.=p
perte	perte	NOMcom	NOMB.=s|GENRE=f|CAS=n
aille	aler	VERcjg	MODE=sub|TEMPS=pst|PERS.=3|NOMB.=s
avras	avoir	VERcjg	MODE=ind|TEMPS=fut|PERS.=2|NOMB.=s
gent	gent1	NOMcom	NOMB.=s|GENRE=f|CAS=r
valissant	valissant	ADJqua	NOMB.=s|GENRE=f|CAS=r|DEGRE=p
paille	paille	NOMcom	NOMB.=s|GENRE=f|CAS=r
gent	gent1	NOMcom	NOMB.=p|GENRE=m|CAS=n
sont	estre1	VERcjg	MODE=ind|TEMPS=pst|PERS.=3|NOMB.=p
frapaille	frapaille	NOMcom	NOMB.=s|GENRE=f|CAS=n
ociront	ocire	VERcjg	MODE=ind|TEMPS=fut|PERS.=3|NOMB.=p
est	estre1	VERcjg	MODE=ind|TEMPS=pst|PERS.=3|NOMB.=s
devinaille	devinaille	NOMcom	NOMB.=s|GENRE=f|CAS=n
di	dire	VERcjg	MODE=ind|TEMPS=pst|PERS.=1|NOMB.=s
cuer	cuer2	NOMcom	NOMB.=s|GENRE=m|CAS=r
coraille	coraille	NOMcom	NOMB.=s|GENRE=f|CAS=r
trairont	traire	VERcjg	MODE=ind|TEMPS=fut|PERS.=3|NOMB.=p
branc	brant1	NOMcom	NOMB.=s|GENRE=m|CAS=r
taille	taillier1	VERcjg	MODE=ind|TEMPS=pst|PERS.=3|NOMB.=s
Biax	bel1	ADJqua	NOMB.=s|GENRE=m|CAS=n|DEGRE=p
fix	fil2	NOMcom	NOMB.=s|GENRE=m|CAS=n
droiturier	droiturier2	ADJqua	NOMB.=s|GENRE=m|CAS=r|DEGRE=p
grant	grant	ADJqua	NOMB.=s|GENRE=m|CAS=r|DEGRE=p
tort	tort2	NOMcom	NOMB.=s|GENRE=m|CAS=r
guere	guerre	NOMcom	NOMB.=s|GENRE=f|CAS=r
commencier	comencier	VERinf	MORPH=empty
di	dire	VERcjg	MODE=imp|PERS.=2|NOMB.=s
escera	eschëoir	VERcjg	MODE=ind|TEMPS=psp|PERS.=3|NOMB.=s
as	avoir	VERcjg	MODE=ind|TEMPS=pst|PERS.=2|NOMB.=s
norri	norrir	VERppe	NOMB.=s|GENRE=m|CAS=r
as	avoir	VERcjg	MODE=ind|TEMPS=pst|PERS.=2|NOMB.=s
fait	faire	VERppe	NOMB.=s|GENRE=m|CAS=r
chevalier	chevalier	NOMcom	NOMB.=s|GENRE=m|CAS=r
traïnans	träiner	VERppa	NOMB.=s|GENRE=m|CAS=n
iert	estre1	VERcjg	MODE=ind|TEMPS=fut|PERS.=3|NOMB.=s
bouele	böele	NOMcom	NOMB.=s|GENRE=f|CAS=n
lais	laissier	VERcjg	MODE=ind|TEMPS=pst|PERS.=1|NOMB.=s
vaillant	valoir	VERppa	NOMB.=s|GENRE=f|CAS=r
prunele	prunele	NOMcom	NOMB.=s|GENRE=f|CAS=r
dist	dire	VERcjg	MODE=ind|TEMPS=psp|PERS.=3|NOMB.=s
dame	dame	NOMcom	NOMB.=s|GENRE=f|CAS=n
cuisant	cuisant	ADJqua	NOMB.=s|GENRE=f|CAS=n|DEGRE=p
estencele	estencele	NOMcom	NOMB.=s|GENRE=f|CAS=n
morras	morir	VERcjg	MODE=ind|TEMPS=fut|PERS.=2|NOMB.=s
cuers	cuer2	NOMcom	NOMB.=s|GENRE=m|CAS=n
revele	reveler2	VERcjg	MODE=ind|TEMPS=pst|PERS.=3|NOMB.=s
Biaus	bel1	ADJqua	NOMB.=s|GENRE=m|CAS=n|DEGRE=p
fix	fil2	NOMcom	NOMB.=s|GENRE=m|CAS=n
fuse	estre1	VERcjg	MODE=sub|TEMPS=ipf|PERS.=1|NOMB.=s
creüe	croire	VERppe	NOMB.=s|GENRE=f|CAS=n
sui	estre1	VERcjg	MODE=ind|TEMPS=pst|PERS.=1|NOMB.=s
vielle	vieil	ADJqua	NOMB.=s|GENRE=f|CAS=n|DEGRE=p
chenue	chenu	ADJqua	NOMB.=s|GENRE=f|CAS=n|DEGRE=p
sui	estre1	VERcjg	MODE=ind|TEMPS=pst|PERS.=1|NOMB.=s
cens	sens	NOMcom	NOMB.=s|GENRE=m|CAS=r
esperdue	esperdre	VERppe	NOMB.=s|GENRE=f|CAS=n
guerre	guerre	NOMcom	NOMB.=s|GENRE=f|CAS=n
fust	estre1	VERcjg	MODE=sub|TEMPS=ipf|PERS.=3|NOMB.=s
meue	movoir	VERppe	NOMB.=s|GENRE=f|CAS=n
oï	öir	VERcjg	MODE=ind|TEMPS=psp|PERS.=3|NOMB.=s
cors	cors1	NOMcom	NOMB.=s|GENRE=m|CAS=n
tressue	tressüer	VERcjg	MODE=ind|TEMPS=pst|PERS.=3|NOMB.=s
apele	apeler	VERcjg	MODE=ind|TEMPS=pst|PERS.=3|NOMB.=s
fiere	fier	ADJqua	NOMB.=s|GENRE=f|CAS=r|DEGRE=p
veüe	veüe	NOMcom	NOMB.=s|GENRE=f|CAS=r
Gardez	garder	VERcjg	MODE=imp|PERS.=2|NOMB.=p
soit	estre1	VERcjg	MODE=sub|TEMPS=pst|PERS.=3|NOMB.=s
gens	gent1	NOMcom	NOMB.=s|GENRE=f|CAS=n
esmeüe	esmovoir	VERppe	NOMB.=s|GENRE=f|CAS=n
soit	estre1	VERcjg	MODE=sub|TEMPS=pst|PERS.=3|NOMB.=s
guere	guerre	NOMcom	NOMB.=s|GENRE=f|CAS=n
creüe	croistre	VERppe	NOMB.=s|GENRE=f|CAS=n
eglise	eglise	NOMcom	NOMB.=s|GENRE=f|CAS=n
soit	estre1	VERcjg	MODE=sub|TEMPS=pst|PERS.=3|NOMB.=s
arse	ardre	VERppe	NOMB.=s|GENRE=f|CAS=n
confondue	confondre	VERppe	NOMB.=s|GENRE=f|CAS=n
Laissiés	laissier	VERcjg	MODE=imp|PERS.=2|NOMB.=p
dame	dame	NOMcom	NOMB.=s|GENRE=f|CAS=r
vielle	vieil	ADJqua	NOMB.=s|GENRE=f|CAS=n|DEGRE=p
est	estre1	VERcjg	MODE=ind|TEMPS=pst|PERS.=3|NOMB.=s
remasue	remanoir	VERppe	NOMB.=s|GENRE=f|CAS=n
gens	gent1	NOMcom	NOMB.=s|GENRE=f|CAS=n
blasme	blasmer	VERcjg	MODE=ind|TEMPS=pst|PERS.=3|NOMB.=s
est	estre1	VERcjg	MODE=ind|TEMPS=pst|PERS.=3|NOMB.=s
venue	venir	VERppe	NOMB.=s|GENRE=f|CAS=n
Ot	öir	VERcjg	MODE=ind|TEMPS=pst|PERS.=3|NOMB.=s
rois	roi2	NOMcom	NOMB.=s|GENRE=m|CAS=n
est	estre1	VERcjg	MODE=ind|TEMPS=pst|PERS.=3|NOMB.=s
enclinez	encliner	VERppe	NOMB.=s|GENRE=m|CAS=n
redrecier	redrecier	NOMcom	NOMB.=x|GENRE=x|CAS=x
a	avoir	VERcjg	MODE=ind|TEMPS=pst|PERS.=3|NOMB.=s
aresonné	araisnier	VERppe	NOMB.=s|GENRE=m|CAS=r
Sire	seignor	NOMcom	NOMB.=s|GENRE=m|CAS=n
dist	dire	VERcjg	MODE=ind|TEMPS=psp|PERS.=3|NOMB.=s
frans	franc1	ADJqua	NOMB.=s|GENRE=m|CAS=n|DEGRE=p
voi	vëoir	VERcjg	MODE=ind|TEMPS=pst|PERS.=1|NOMB.=s
plain	plein	ADJqua	NOMB.=s|GENRE=m|CAS=n|DEGRE=p
es	estre1	VERcjg	MODE=ind|TEMPS=pst|PERS.=2|NOMB.=s
maustalans	mautalent	NOMcom	NOMB.=s|GENRE=m|CAS=r
Voir	voir	ADJqua	NOMB.=s|GENRE=m|CAS=n|DEGRE=p
dit	dire	VERcjg	MODE=ind|TEMPS=pst|PERS.=3|NOMB.=s
furent	estre1	VERcjg	MODE=ind|TEMPS=psp|PERS.=3|NOMB.=p
parant	parent	NOMcom	NOMB.=p|GENRE=m|CAS=n
vet	aler	VERcjg	MODE=ind|TEMPS=pst|PERS.=3|NOMB.=s
omme	ome	NOMcom	NOMB.=s|GENRE=m|CAS=r
sert	servir	VERcjg	MODE=ind|TEMPS=pst|PERS.=3|NOMB.=s
male	mal1	ADJqua	NOMB.=s|GENRE=f|CAS=r|DEGRE=p
gent	gent1	NOMcom	NOMB.=s|GENRE=f|CAS=r
fet	faire	VERcjg	MODE=ind|TEMPS=pst|PERS.=3|NOMB.=s
gaaigne	gäaignier1	VERcjg	MODE=ind|TEMPS=pst|PERS.=3|NOMB.=s
vet	aler	VERcjg	MODE=ind|TEMPS=pst|PERS.=3|NOMB.=s
enpirant	empirier	VERppa	NOMB.=x|GENRE=x|CAS=x
Sire	seignor	NOMcom	NOMB.=s|GENRE=m|CAS=n
dit	dire	VERcjg	MODE=ind|TEMPS=pst|PERS.=3|NOMB.=s
proz	pro	ADJqua	NOMB.=s|GENRE=m|CAS=n|DEGRE=p
voi	vëoir	VERcjg	MODE=ind|TEMPS=pst|PERS.=1|NOMB.=s
mautalant	mautalent	NOMcom	NOMB.=s|GENRE=m|CAS=r
avez	avoir	VERcjg	MODE=ind|TEMPS=pst|PERS.=2|NOMB.=p
Dit	dire	VERcjg	MODE=ind|TEMPS=pst|PERS.=3|NOMB.=s
orent	avoir	VERcjg	MODE=ind|TEMPS=psp|PERS.=3|NOMB.=p
encessor	ancessor	NOMcom	NOMB.=p|GENRE=m|CAS=n
vet	aler	VERcjg	MODE=ind|TEMPS=pst|PERS.=3|NOMB.=s
ome	ome	NOMcom	NOMB.=s|GENRE=m|CAS=r
sert	servir	VERcjg	MODE=ind|TEMPS=pst|PERS.=3|NOMB.=s
mauvés	mauvais	ADJqua	NOMB.=s|GENRE=m|CAS=r|DEGRE=p
seignor	seignor	NOMcom	NOMB.=s|GENRE=m|CAS=r
alieve	alever	VERcjg	MODE=ind|TEMPS=pst|PERS.=3|NOMB.=s
gaaingne	gäaignier1	VERcjg	MODE=ind|TEMPS=pst|PERS.=3|NOMB.=s
Sire	seignor	NOMcom	NOMB.=s|GENRE=m|CAS=n
respont	respondre1	VERcjg	MODE=ind|TEMPS=pst|PERS.=3|NOMB.=s
gardé	garder	VERppe	NOMB.=s|GENRE=m|CAS=r
avez	avoir	VERcjg	MODE=ind|TEMPS=pst|PERS.=2|NOMB.=p
servi	servir	VERppe	NOMB.=s|GENRE=m|CAS=r
amor	amor	NOMcom	NOMB.=s|GENRE=f|CAS=r
Beau	bel1	ADJqua	NOMB.=s|GENRE=m|CAS=n|DEGRE=p
niés	nevo	NOMcom	NOMB.=s|GENRE=m|CAS=n
dit	dire	VERcjg	MODE=ind|TEMPS=pst|PERS.=3|NOMB.=s
entendez	entendre	VERcjg	MODE=imp|PERS.=2|NOMB.=p
mestier	mestier	NOMcom	NOMB.=s|GENRE=m|CAS=r
estes	estre1	VERcjg	MODE=ind|TEMPS=pst|PERS.=2|NOMB.=p
mellez	mesler	VERppe	NOMB.=s|GENRE=m|CAS=n
pert	paroir	VERcjg	MODE=ind|TEMPS=pst|PERS.=3|NOMB.=s
savez	savoir	VERcjg	MODE=ind|TEMPS=pst|PERS.=2|NOMB.=p
Ot	öir	VERcjg	MODE=ind|TEMPS=pst|PERS.=3|NOMB.=s
est	estre1	VERcjg	MODE=ind|TEMPS=pst|PERS.=3|NOMB.=s
forssenez	forsener	VERppe	NOMB.=s|GENRE=m|CAS=n
tonne	tone	NOMcom	NOMB.=s|GENRE=f|CAS=r
quens	conte1	NOMcom	NOMB.=s|GENRE=m|CAS=n
dut	devoir	VERcjg	MODE=ind|TEMPS=psp|PERS.=3|NOMB.=s
mener	mener	VERinf	MORPH=empty
fu	estre1	VERcjg	MODE=ind|TEMPS=psp|PERS.=3|NOMB.=s
ber	baron	NOMcom	NOMB.=s|GENRE=m|CAS=n
Sire	seignor	NOMcom	NOMB.=s|GENRE=m|CAS=n
conduire	conduire	VERinf	MORPH=empty
penssez	penser	VERcjg	MODE=imp|PERS.=2|NOMB.=s
gardons	garder	VERcjg	MODE=imp|PERS.=1|NOMB.=p
eure	ore3	NOMcom	NOMB.=s|GENRE=f|CAS=r
soions	estre1	VERcjg	MODE=sub|TEMPS=pst|PERS.=1|NOMB.=p
verssez	verser2	VERppe	NOMB.=p|GENRE=m|CAS=n
dit	dire	VERcjg	MODE=ind|TEMPS=pst|PERS.=3|NOMB.=s
tans	tens	NOMcom	NOMB.=s|GENRE=m|CAS=r
vendrez	venir	VERcjg	MODE=ind|TEMPS=fut|PERS.=2|NOMB.=p
chars	char1	NOMcom	NOMB.=p|GENRE=m|CAS=r
devons	devoir	VERcjg	MODE=ind|TEMPS=pst|PERS.=1|NOMB.=p
chanter	chanter	VERinf	MORPH=empty
charroi	charroi	NOMcom	NOMB.=s|GENRE=m|CAS=r
devoient	devoir	VERcjg	MODE=ind|TEMPS=ipf|PERS.=3|NOMB.=p
mener	mener	VERinf	MORPH=empty
portent	porter	VERcjg	MODE=ind|TEMPS=pst|PERS.=3|NOMB.=p
corroies	coroie	NOMcom	NOMB.=p|GENRE=f|CAS=r
gueles	guille	NOMcom	NOMB.=p|GENRE=f|CAS=r
baudrez	baudré	NOMcom	NOMB.=p|GENRE=m|CAS=r
portent	porter	VERcjg	MODE=ind|TEMPS=pst|PERS.=3|NOMB.=p
grans	grant	ADJqua	NOMB.=p|GENRE=f|CAS=r|DEGRE=p
borsses	borse	NOMcom	NOMB.=p|GENRE=f|CAS=r
monnoie	monoie	NOMcom	NOMB.=s|GENRE=f|CAS=r
chengier	changier	VERinf	MORPH=empty
chevauchent	chevauchier	VERcjg	MODE=ind|TEMPS=pst|PERS.=3|NOMB.=p
mules	mule5	NOMcom	NOMB.=p|GENRE=f|CAS=n
sommiers	somier2	NOMcom	NOMB.=p|GENRE=m|CAS=n
gastez	gaster	VERppe	NOMB.=p|GENRE=m|CAS=n
veut	voloir	VERcjg	MODE=ind|TEMPS=pst|PERS.=3|NOMB.=s
estre	estre1	VERinf	MORPH=empty
enprisonnez	emprisoner	VERppe	NOMB.=s|GENRE=m|CAS=n
besoing	besoing	NOMcom	NOMB.=s|GENRE=m|CAS=r
vient	venir	VERcjg	MODE=ind|TEMPS=pst|PERS.=3|NOMB.=s
puist	pöoir	VERcjg	MODE=sub|TEMPS=ipf|PERS.=3|NOMB.=s
delivrer	delivrer	VERinf	MORPH=empty
uis	uis	NOMcom	NOMB.=s|GENRE=m|CAS=r
palés	palais2	NOMcom	NOMB.=s|GENRE=m|CAS=r
ont	avoir	VERcjg	MODE=ind|TEMPS=pst|PERS.=3|NOMB.=p
estoupé	estoper	VERppe	NOMB.=s|GENRE=m|CAS=r
sera	estre1	VERcjg	MODE=ind|TEMPS=fut|PERS.=3|NOMB.=s
grief	grief	ADJqua	NOMB.=s|GENRE=m|CAS=n|DEGRE=p
entrer	entrer	NOMcom	NOMB.=x|GENRE=x|CAS=x
roi	roi2	NOMcom	NOMB.=s|GENRE=m|CAS=n
comança	comencier	VERcjg	MODE=ind|TEMPS=psp|PERS.=3|NOMB.=s
dire	dire	VERinf	MORPH=empty
frere	frere	NOMcom	NOMB.=s|GENRE=m|CAS=n
loi	loi3	NOMcom	NOMB.=s|GENRE=f|CAS=r
vives	vivre1	VERcjg	MODE=sub|TEMPS=pst|PERS.=2|NOMB.=s
as	avoir	VERcjg	MODE=ind|TEMPS=pst|PERS.=2|NOMB.=s
conquis	conquerre	VERppe	NOMB.=s|GENRE=m|CAS=r
riche	riche	ADJqua	NOMB.=s|GENRE=m|CAS=r|DEGRE=p
menantie	manandie	NOMcom	NOMB.=s|GENRE=f|CAS=r
païs	päis	NOMcom	NOMB.=s|GENRE=m|CAS=r
terre	terre	NOMcom	NOMB.=s|GENRE=f|CAS=r
est	estre1	VERcjg	MODE=ind|TEMPS=pst|PERS.=3|NOMB.=s
vie	vie1	NOMcom	NOMB.=s|GENRE=f|CAS=n
dit	dire	VERcjg	MODE=ind|TEMPS=pst|PERS.=3|NOMB.=s
sé	savoir	VERcjg	MODE=ind|TEMPS=pst|PERS.=1|NOMB.=s
dire	dire	VERinf	MORPH=empty
douce	douz	ADJqua	NOMB.=s|GENRE=f|CAS=r|DEGRE=p
é	avoir	VERcjg	MODE=ind|TEMPS=pst|PERS.=1|NOMB.=s
conquise	conquerre	VERppe	NOMB.=s|GENRE=f|CAS=r
vois	aler	VERcjg	MODE=ind|TEMPS=pst|PERS.=1|NOMB.=s
voir	voir	ADJqua	NOMB.=s|GENRE=m|CAS=r|DEGRE=p
reving	revenir	VERcjg	MODE=ind|TEMPS=psp|PERS.=1|NOMB.=s
mer	mer	NOMcom	NOMB.=s|GENRE=f|CAS=r
demant	demander	VERcjg	MODE=ind|TEMPS=pst|PERS.=1|NOMB.=s
cité	cité	NOMcom	NOMB.=s|GENRE=f|CAS=r
fet	faire	VERcjg	MODE=ind|TEMPS=pst|PERS.=3|NOMB.=s
loer	löer1	VERinf	MORPH=empty
donnés	doner	VERcjg	MODE=ind|TEMPS=pst|PERS.=2|NOMB.=p
afiert	aferir	VERcjg	MODE=ind|TEMPS=pst|PERS.=3|NOMB.=s
gré	gré2	NOMcom	NOMB.=s|GENRE=m|CAS=r
escus	escu	NOMcom	NOMB.=s|GENRE=m|CAS=n
fu	estre1	VERcjg	MODE=ind|TEMPS=psp|PERS.=3|NOMB.=s
portez	porter	VERppe	NOMB.=s|GENRE=m|CAS=n
chevaliers	chevalier	NOMcom	NOMB.=s|GENRE=m|CAS=n
fust	estre1	VERcjg	MODE=sub|TEMPS=ipf|PERS.=3|NOMB.=s
chasez	chaser	VERppe	NOMB.=s|GENRE=m|CAS=n
ot	avoir	VERcjg	MODE=ind|TEMPS=psp|PERS.=3|NOMB.=s
hauberc	hauberc	NOMcom	NOMB.=s|GENRE=m|CAS=r
vestu	vestir	VERppe	NOMB.=s|GENRE=m|CAS=r
endossé	endosser	VERppe	NOMB.=s|GENRE=m|CAS=r
di	dire	VERcjg	MODE=ind|TEMPS=pst|PERS.=1|NOMB.=s
fine	fin2	ADJqua	NOMB.=s|GENRE=f|CAS=r|DEGRE=p
verité	verité	NOMcom	NOMB.=s|GENRE=f|CAS=r
apovroiés	apovrir	VERppe	NOMB.=s|GENRE=m|CAS=n
iert	estre1	VERcjg	MODE=ind|TEMPS=fut|PERS.=3|NOMB.=s
regnez	regné	NOMcom	NOMB.=s|GENRE=m|CAS=n
Oït	öir	VERcjg	MODE=ind|TEMPS=psp|PERS.=3|NOMB.=s
rois	roi2	NOMcom	NOMB.=s|GENRE=m|CAS=n
a	avoir	VERcjg	MODE=ind|TEMPS=pst|PERS.=3|NOMB.=s
penssé	penser	VERppe	NOMB.=s|GENRE=m|CAS=r
sire	seignor	NOMcom	NOMB.=s|GENRE=m|CAS=n
dist	dire	VERcjg	MODE=ind|TEMPS=psp|PERS.=3|NOMB.=s
fors	fort	ADJqua	NOMB.=s|GENRE=m|CAS=n|DEGRE=p
donne	doner	VERcjg	MODE=imp|PERS.=2|NOMB.=s
pors	port2	NOMcom	NOMB.=p|GENRE=m|CAS=r
iert	estre1	VERcjg	MODE=ind|TEMPS=fut|PERS.=3|NOMB.=s
terre	terre	NOMcom	NOMB.=s|GENRE=f|CAS=n
iert	estre1	VERcjg	MODE=ind|TEMPS=fut|PERS.=3|NOMB.=s
§tresois	tresor	NOMcom	NOMB.=s|GENRE=m|CAS=n
chevaliers	chevalier	NOMcom	NOMB.=p|GENRE=m|CAS=r
porrai	pöoir	VERcjg	MODE=ind|TEMPS=fut|PERS.=1|NOMB.=s
livrer	livrer	VERinf	MORPH=empty
ost	ost	NOMcom	NOMB.=s|GENRE=f|CAS=r
Donne	doner	VERcjg	MODE=imp|PERS.=2|NOMB.=s
rois	roi2	NOMcom	NOMB.=s|GENRE=m|CAS=n
terre	terre	NOMcom	NOMB.=s|GENRE=f|CAS=r
est	estre1	VERcjg	MODE=ind|TEMPS=pst|PERS.=3|NOMB.=s
barnaje	barnage	NOMcom	NOMB.=s|GENRE=m|CAS=r
beneie	benëir	VERcjg	MODE=sub|TEMPS=pst|PERS.=3|NOMB.=s
fier	fier	ADJqua	NOMB.=s|GENRE=m|CAS=r|DEGRE=p
fust	estre1	VERcjg	MODE=sub|TEMPS=ipf|PERS.=3|NOMB.=s
vie	vie1	NOMcom	NOMB.=s|GENRE=f|CAS=r
seint	saint	ADJqua	NOMB.=s|GENRE=m|CAS=r|DEGRE=p
mestre	maistre	ADJqua	NOMB.=s|GENRE=f|CAS=r|DEGRE=p
abaie	abeie	NOMcom	NOMB.=s|GENRE=f|CAS=r
trovons	trover	VERcjg	MODE=ind|TEMPS=pst|PERS.=1|NOMB.=p
escrit	escrit	VERppe	NOMB.=s|GENRE=m|CAS=r
doute	doter2	VERcjg	MODE=imp|PERS.=2|NOMB.=s
livre	livre2	NOMcom	NOMB.=s|GENRE=m|CAS=r
grant	grant	ADJqua	NOMB.=s|GENRE=f|CAS=r|DEGRE=p
encesorie	ancesserie	NOMcom	NOMB.=s|GENRE=f|CAS=r
ot	avoir	VERcjg	MODE=ind|TEMPS=psp|PERS.=3|NOMB.=s
gestes	geste2	NOMcom	NOMB.=p|GENRE=f|CAS=r
garnie	garnir	VERppe	NOMB.=s|GENRE=f|CAS=r
cuit	cuidier1	VERcjg	MODE=ind|TEMPS=pst|PERS.=1|NOMB.=s
desdie	desdire	VERcjg	MODE=sub|TEMPS=pst|PERS.=3|NOMB.=s
rois	roi2	NOMcom	NOMB.=p|GENRE=m|CAS=r
est	estre1	VERcjg	MODE=ind|TEMPS=pst|PERS.=3|NOMB.=s
seignorie	seignorie	NOMcom	NOMB.=s|GENRE=f|CAS=n
est	estre1	VERcjg	MODE=ind|TEMPS=pst|PERS.=3|NOMB.=s
droiz	droit	ADJqua	NOMB.=s|GENRE=m|CAS=n|DEGRE=p
die	dire	VERcjg	MODE=sub|TEMPS=pst|PERS.=1|NOMB.=s
Fu	estre1	VERcjg	MODE=ind|TEMPS=psp|PERS.=3|NOMB.=s
barbe	barbe	NOMcom	NOMB.=s|GENRE=f|CAS=r
florie	florir	VERppe	NOMB.=s|GENRE=f|CAS=r
ot	avoir	VERcjg	MODE=ind|TEMPS=psp|PERS.=3|NOMB.=s
baronnie	baronie	NOMcom	NOMB.=s|GENRE=f|CAS=r
lingnaje	lignage	NOMcom	NOMB.=s|GENRE=m|CAS=r
ot	avoir	VERcjg	MODE=ind|TEMPS=psp|PERS.=3|NOMB.=s
gent	gent1	NOMcom	NOMB.=s|GENRE=f|CAS=r
fiere	fier	ADJqua	NOMB.=s|GENRE=f|CAS=r|DEGRE=p
hardie	hardi	ADJqua	NOMB.=s|GENRE=f|CAS=r|DEGRE=p
eusent	avoir	VERcjg	MODE=sub|TEMPS=ipf|PERS.=3|NOMB.=p
seignorie	seignorie	NOMcom	NOMB.=s|GENRE=f|CAS=r
richece	richece	NOMcom	NOMB.=s|GENRE=f|CAS=r
chevalerie	chevalerie	NOMcom	NOMB.=s|GENRE=f|CAS=r
fusent	estre1	VERcjg	MODE=sub|TEMPS=ipf|PERS.=3|NOMB.=p
plain	plein	ADJqua	NOMB.=p|GENRE=m|CAS=n|DEGRE=p
orgueil	orgueil	NOMcom	NOMB.=s|GENRE=m|CAS=r
envie	envie	NOMcom	NOMB.=s|GENRE=f|CAS=r
pleure	plorer	VERcjg	MODE=ind|TEMPS=pst|PERS.=3|NOMB.=s
dus	duc2	NOMcom	NOMB.=s|GENRE=m|CAS=n
plaint	plaindre	VERcjg	MODE=ind|TEMPS=pst|PERS.=3|NOMB.=s
soupire	sospirer	VERcjg	MODE=ind|TEMPS=pst|PERS.=3|NOMB.=s
larmes	larme	NOMcom	NOMB.=p|GENRE=f|CAS=r
regrete	regreter	VERcjg	MODE=ind|TEMPS=pst|PERS.=3|NOMB.=s
douce	douz	ADJqua	NOMB.=s|GENRE=f|CAS=r|DEGRE=p
castiaus	chastel	NOMcom	NOMB.=p|GENRE=m|CAS=r
marces	marche1	NOMcom	NOMB.=p|GENRE=f|CAS=r
fesis	faire	VERcjg	MODE=sub|TEMPS=ipf|PERS.=2|NOMB.=s
biaus	bel1	ADJqua	NOMB.=s|GENRE=m|CAS=n|DEGRE=p
serouges	serorge1	NOMcom	NOMB.=s|GENRE=m|CAS=n
fieus	fil2	NOMcom	NOMB.=s|GENRE=m|CAS=n
cachas	chacier	VERcjg	MODE=ind|TEMPS=psp|PERS.=2|NOMB.=s
acointas	acointier	VERcjg	MODE=ind|TEMPS=psp|PERS.=2|NOMB.=s
ert	estre1	VERcjg	MODE=ind|TEMPS=fut|PERS.=3|NOMB.=s
seus	sol1	ADJqua	NOMB.=s|GENRE=m|CAS=n|DEGRE=p
jors	jor	NOMcom	NOMB.=s|GENRE=m|CAS=n
hace	häir	VERcjg	MODE=sub|TEMPS=pst|PERS.=1|NOMB.=s
Biaus	bel1	ADJqua	NOMB.=s|GENRE=m|CAS=n|DEGRE=p
fieus	fil2	NOMcom	NOMB.=s|GENRE=m|CAS=n
sai	savoir	VERcjg	MODE=ind|TEMPS=pst|PERS.=1|NOMB.=s
face	faire	VERcjg	MODE=sub|TEMPS=pst|PERS.=1|NOMB.=s
manoir	manoir1	VERinf	MORPH=empty
bos	bois	NOMcom	NOMB.=p|GENRE=m|CAS=r
serés	estre1	VERcjg	MODE=ind|TEMPS=fut|PERS.=2|NOMB.=p
sages	sage	ADJqua	NOMB.=s|GENRE=m|CAS=n|DEGRE=p
devenrés	devenir	VERcjg	MODE=ind|TEMPS=fut|PERS.=2|NOMB.=p
sos	sot	ADJqua	NOMB.=s|GENRE=m|CAS=n|DEGRE=p
enfantieus	enfantif	ADJqua	NOMB.=s|GENRE=m|CAS=n|DEGRE=p
savages	sauvage	ADJqua	NOMB.=s|GENRE=m|CAS=n|DEGRE=p
oi	avoir	VERcjg	MODE=ind|TEMPS=psp|PERS.=1|NOMB.=s
voie	voie	NOMcom	NOMB.=s|GENRE=f|CAS=r
tenue	tenir1	VERppe	NOMB.=s|GENRE=f|CAS=r
forest	forest	NOMcom	NOMB.=s|GENRE=f|CAS=r
lande	lande1	NOMcom	NOMB.=s|GENRE=f|CAS=r
montant	monter	VERppa	NOMB.=s|GENRE=f|CAS=r
liues	lieue	NOMcom	NOMB.=p|GENRE=f|CAS=r
demie	demi2	ADJqua	NOMB.=s|GENRE=f|CAS=r|DEGRE=p
liue	lieue	NOMcom	NOMB.=s|GENRE=f|CAS=r
coisi	choisir	VERcjg	MODE=ind|TEMPS=psp|PERS.=1|NOMB.=s
tertre	tertre	NOMcom	NOMB.=s|GENRE=m|CAS=r
vi	vëoir	VERcjg	MODE=ind|TEMPS=psp|PERS.=1|NOMB.=s
chevalier	chevalier	NOMcom	NOMB.=s|GENRE=m|CAS=r
ert	estre1	VERcjg	MODE=ind|TEMPS=ipf|PERS.=3|NOMB.=s
apoiés	apoiier	VERppe	NOMB.=s|GENRE=m|CAS=n
glaive	glaive	NOMcom	NOMB.=s|GENRE=f|CAS=r
ot	avoir	VERcjg	MODE=ind|TEMPS=psp|PERS.=3|NOMB.=s
ficiés	fichier	VERppe	NOMB.=p|GENRE=m|CAS=r
pensoit	penser	VERcjg	MODE=ind|TEMPS=ipf|PERS.=3|NOMB.=s
est	estre1	VERcjg	MODE=ind|TEMPS=pst|PERS.=3|NOMB.=s
avis	avis	NOMcom	NOMB.=s|GENRE=m|CAS=n
apensai	apenser	VERcjg	MODE=ind|TEMPS=psp|PERS.=1|NOMB.=s
estoit	estre1	VERcjg	MODE=ind|TEMPS=ipf|PERS.=3|NOMB.=s
chevaliers	chevalier	NOMcom	NOMB.=s|GENRE=m|CAS=n
atendoit	atendre	VERcjg	MODE=ind|TEMPS=ipf|PERS.=3|NOMB.=s
aventure	aventure	NOMcom	NOMB.=s|GENRE=f|CAS=r
envoiai	envoiier	VERcjg	MODE=ind|TEMPS=psp|PERS.=1|NOMB.=s
delaiai	delaiier1	VERcjg	MODE=ind|TEMPS=psp|PERS.=1|NOMB.=s
vint	venir	VERcjg	MODE=ind|TEMPS=psp|PERS.=3|NOMB.=s
vit	vëoir	VERcjg	MODE=ind|TEMPS=psp|PERS.=3|NOMB.=s
chevaliers	chevalier	NOMcom	NOMB.=s|GENRE=m|CAS=n
