form	lemma	POS	morph
Une	un	DETndf	NOMB.=s|GENRE=f|CAS=n
ymagene	image	NOMcom	NOMB.=s|GENRE=f|CAS=n
mut	mout	ADVgen	DEGRE=-
bele	bel1	ADJqua	NOMB.=s|GENRE=f|CAS=n|DEGRE=p
fut	estre1	VERcjg	MODE=ind|TEMPS=psp|PERS.=3|NOMB.=s
el	en1+le	PRE.DETdef	MORPH=empty+NOMB.=s|GENRE=m|CAS=r
mostier	mostier	NOMcom	NOMB.=s|GENRE=m|CAS=r
poseie	poser	VERppe	NOMB.=s|GENRE=f|CAS=n
el	en1+le	PRE.DETdef	MORPH=empty+NOMB.=s|GENRE=m|CAS=r
nom	nom	NOMcom	NOMB.=s|GENRE=m|CAS=r
la	le	DETdef	NOMB.=s|GENRE=f|CAS=r
mere	mere	NOMcom	NOMB.=s|GENRE=f|CAS=r
Deu	Dieu	NOMpro	NOMB.=s|GENRE=m|CAS=r
et	et	CONcoo	MORPH=empty
faite	faire	VERppe	NOMB.=s|GENRE=f|CAS=n
et	et	CONcoo	MORPH=empty
figureie	figurer	VERppe	NOMB.=s|GENRE=f|CAS=n
Par	par	PRE	MORPH=empty
amur	amor	NOMcom	NOMB.=s|GENRE=f|CAS=r
al	a3+le	PRE.DETdef	MORPH=empty+NOMB.=s|GENRE=m|CAS=r
saint	saint	ADJqua	NOMB.=s|GENRE=m|CAS=r|DEGRE=p
homme	ome	NOMcom	NOMB.=s|GENRE=m|CAS=r
l	il	PROper	PERS.=3|NOMB.=s|GENRE=f|CAS=r
ait	avoir	VERcjg	MODE=ind|TEMPS=pst|PERS.=3|NOMB.=s
Deus	Dieu	NOMpro	NOMB.=s|GENRE=m|CAS=n
illumineie	illuminer	VERppe	NOMB.=s|GENRE=f|CAS=r
parleir	parler	VERinf	MORPH=empty
la	il	PROper	PERS.=3|NOMB.=s|GENRE=f|CAS=r
fist	faire	VERcjg	MODE=ind|TEMPS=psp|PERS.=3|NOMB.=s
cum	come1	CONsub	MORPH=empty
feme	feme	NOMcom	NOMB.=s|GENRE=f|CAS=r
qui	qui	PROrel	NOMB.=s|GENRE=f|CAS=n
fust	estre1	VERcjg	MODE=sub|TEMPS=ipf|PERS.=3|NOMB.=s
vive	vif	ADJqua	NOMB.=s|GENRE=f|CAS=n|DEGRE=p
et	et	CONcoo	MORPH=empty
seneie	sené2	ADJqua	NOMB.=s|GENRE=f|CAS=n|DEGRE=p
Lo	le	DETdef	NOMB.=s|GENRE=m|CAS=r
sogrestain	secrestain	NOMcom	NOMB.=s|GENRE=m|CAS=r
apele	apeler	VERcjg	MODE=ind|TEMPS=pst|PERS.=3|NOMB.=s
un	un	DETndf	NOMB.=s|GENRE=m|CAS=r
jor	jor	NOMcom	NOMB.=s|GENRE=m|CAS=r
à	a3	PRE	MORPH=empty
l	le	DETdef	NOMB.=s|GENRE=f|CAS=r
ajorneie	ajornee	NOMcom	NOMB.=s|GENRE=f|CAS=r
Va	aler	VERcjg	MODE=imp|PERS.=2|NOMB.=s
querre	querre	VERinf	MORPH=empty
lo	le	DETdef	NOMB.=s|GENRE=m|CAS=r
saint	saint	ADJqua	NOMB.=s|GENRE=m|CAS=r|DEGRE=p
home	ome	NOMcom	NOMB.=s|GENRE=m|CAS=r
la	là	ADVgen	DEGRE=-
cui	cui	PROrel	NOMB.=s|GENRE=m|CAS=i
vie	vie1	NOMcom	NOMB.=s|GENRE=f|CAS=n
est	estre1	VERcjg	MODE=ind|TEMPS=pst|PERS.=3|NOMB.=s
loeie	löer1	VERppe	NOMB.=s|GENRE=f|CAS=n
En	en1	PRE	MORPH=empty
ciel	ciel	NOMcom	NOMB.=s|GENRE=m|CAS=r
od	o4	PRE	MORPH=empty
les	le	DETdef	NOMB.=p|GENRE=m|CAS=r
sainz	saint	ADJqua	NOMB.=p|GENRE=m|CAS=r|DEGRE=p
angeles	angele	NOMcom	NOMB.=p|GENRE=m|CAS=r
est	estre1	VERcjg	MODE=ind|TEMPS=pst|PERS.=3|NOMB.=s
sovent	sovent	ADVgen	DEGRE=p
recordeie	recorder	VERppe	NOMB.=s|GENRE=f|CAS=n
fai	faire	VERcjg	MODE=imp|PERS.=2|NOMB.=s
le	il	PROper	PERS.=3|NOMB.=s|GENRE=m|CAS=r
entreir	entrer	VERinf	MORPH=empty
el	en1+le	PRE.DETdef	MORPH=empty+NOMB.=s|GENRE=m|CAS=r
mostier	mostier	NOMcom	NOMB.=s|GENRE=m|CAS=r
senz	sans	PRE	MORPH=empty
nule	nul	DETind	NOMB.=s|GENRE=f|CAS=r
demoreie	demoree	NOMcom	NOMB.=s|GENRE=f|CAS=r
bien	bien1	ADVgen	DEGRE=p
est	estre1	VERcjg	MODE=ind|TEMPS=pst|PERS.=3|NOMB.=s
dignes	digne	ADJqua	NOMB.=s|GENRE=m|CAS=n|DEGRE=p
qu	que4	CONsub	MORPH=empty
il	il	PROper	PERS.=3|NOMB.=s|GENRE=m|CAS=n
ait	avoir	VERcjg	MODE=sub|TEMPS=pst|PERS.=3|NOMB.=s
de	de	PRE	MORPH=empty
paradis	paradis	NOMcom	NOMB.=s|GENRE=m|CAS=r
l	le	DETdef	NOMB.=s|GENRE=f|CAS=r
entreie	entree	NOMcom	NOMB.=s|GENRE=f|CAS=r
et	et	CONcoo	MORPH=empty
la	le	DETdef	NOMB.=s|GENRE=f|CAS=n
porte	porte1	NOMcom	NOMB.=s|GENRE=f|CAS=n
del	de+le	PRE.DETdef	MORPH=empty+NOMB.=s|GENRE=m|CAS=r
ciel	ciel	NOMcom	NOMB.=s|GENRE=m|CAS=r
li	il	PROper	PERS.=3|NOMB.=s|GENRE=m|CAS=i
est	estre1	VERcjg	MODE=ind|TEMPS=pst|PERS.=3|NOMB.=s
abandoneie	abandoner	VERppe	NOMB.=s|GENRE=f|CAS=n
car	car	CONcoo	MORPH=empty
la	le	DETdef	NOMB.=s|GENRE=f|CAS=n
sue	suen	ADJpos	PERS.=3|NOMB.=s|GENRE=f|CAS=n
orisons	oraison	NOMcom	NOMB.=s|GENRE=f|CAS=n
est	estre1	VERcjg	MODE=ind|TEMPS=pst|PERS.=3|NOMB.=s
à	a3	PRE	MORPH=empty
Deu	Dieu	NOMpro	NOMB.=s|GENRE=m|CAS=r
tant	tant	ADVgen	DEGRE=-
ameie	amer1	VERppe	NOMB.=s|GENRE=f|CAS=n
plus	plus	ADVgen	DEGRE=c
li	il	PROper	PERS.=3|NOMB.=s|GENRE=m|CAS=i
rent	rendre	VERcjg	MODE=ind|TEMPS=pst|PERS.=3|NOMB.=s
bone	bon	ADJqua	NOMB.=s|GENRE=f|CAS=r|DEGRE=p
odor	odor	NOMcom	NOMB.=s|GENRE=f|CAS=r
ke	que1	CONsub	MORPH=empty
soit	estre1	VERcjg	MODE=sub|TEMPS=pst|PERS.=3|NOMB.=s
mirre	mirre	NOMcom	NOMB.=s|GENRE=f|CAS=n
embraseie	embraser	VERppe	NOMB.=s|GENRE=f|CAS=n
Sainz	saint	ADJqua	NOMB.=s|GENRE=m|CAS=n|DEGRE=p
Espirs	espir	NOMpro	NOMB.=s|GENRE=m|CAS=n
est	estre1	VERcjg	MODE=ind|TEMPS=pst|PERS.=3|NOMB.=s
en	en1	PRE	MORPH=empty
lui	il	PROper	PERS.=3|NOMB.=s|GENRE=m|CAS=r
par	par	PRE	MORPH=empty
cui	cui	PROrel	NOMB.=s|GENRE=m|CAS=r
s	son4	DETpos	PERS.=3|NOMB.=s|GENRE=f|CAS=n
anrme	ame	NOMcom	NOMB.=s|GENRE=f|CAS=n
iert	estre1	VERcjg	MODE=ind|TEMPS=fut|PERS.=3|NOMB.=s
salveie	sauver	VERppe	NOMB.=s|GENRE=f|CAS=n
Quant	cant1	CONsub	MORPH=empty
ot	öir	VERcjg	MODE=ind|TEMPS=pst|PERS.=3|NOMB.=s
li	le	DETdef	NOMB.=s|GENRE=m|CAS=n
sogrestains	secrestain	NOMcom	NOMB.=s|GENRE=m|CAS=n
cele	cel	DETdem	NOMB.=s|GENRE=f|CAS=r
ymagene	image	NOMcom	NOMB.=s|GENRE=f|CAS=r
parleir	parler	VERinf	MORPH=empty
ist	issir	VERcjg	MODE=ind|TEMPS=pst|PERS.=3|NOMB.=s
s	soi1	PROper	PERS.=3|NOMB.=s|GENRE=m|CAS=r
en	en2	PROadv	MORPH=empty
fors	fors1	ADVgen	DEGRE=-
del	de+le	PRE.DETdef	MORPH=empty+NOMB.=s|GENRE=m|CAS=r
mostier	mostier	NOMcom	NOMB.=s|GENRE=m|CAS=r
que	que4	CONcoo	MORPH=empty
n	ne1	ADVneg	MORPH=empty
i	i2	PROadv	MORPH=empty
volt	voloir	VERcjg	MODE=ind|TEMPS=psp|PERS.=3|NOMB.=s
demoreir	demorer	VERinf	MORPH=empty
