form	lemma	POS	morph
En	en1	PRE	MORPH=empty
bon	bon	ADJqua	NOMB.=s|GENRE=m|CAS=r|DEGRE=p
point	point	NOMcom	NOMB.=s|GENRE=m|CAS=r
avés	avoir	VERcjg	MODE=ind|TEMPS=pst|PERS.=2|NOMB.=p
desroute	desrompre	VERppe	NOMB.=s|GENRE=f|CAS=r
la	le	DETdef	NOMB.=s|GENRE=f|CAS=r
compaignie	compagnie	NOMcom	NOMB.=s|GENRE=f|CAS=r
à	a3	PRE	MORPH=empty
ces	ce2	DETdem	NOMB.=p|GENRE=m|CAS=r
chaitis	chaitif	NOMcom	NOMB.=p|GENRE=m|CAS=r
Dont	donc	ADVgen	DEGRE=-
bien	bien1	ADVgen	DEGRE=-
saciés	savoir	VERcjg	MODE=imp|PERS.=2|NOMB.=s
n	ne1	ADVneg	MORPH=empty
ara	avoir	VERcjg	MODE=ind|TEMPS=fut|PERS.=3|NOMB.=s
Juïs	jüif	NOMpro	NOMB.=p|GENRE=m|CAS=r
en	en1	PRE	MORPH=empty
tout	tot	DETind	NOMB.=s|GENRE=m|CAS=r
le	le	DETdef	NOMB.=s|GENRE=m|CAS=r
regne	regne	NOMcom	NOMB.=s|GENRE=m|CAS=r
de	de	PRE	MORPH=empty
Judee	Judée	NOMpro	NOMB.=s|GENRE=f|CAS=r
que	que2	PROrel	NOMB.=s|GENRE=m|CAS=n
mout	mout	ADVgen	DEGRE=-
n	ne1	ADVneg	MORPH=empty
ait	avoir	VERcjg	MODE=sub|TEMPS=pst|PERS.=3|NOMB.=s
mauvaise	mauvais	ADJqua	NOMB.=s|GENRE=f|CAS=r|DEGRE=p
sodee	soudee	NOMcom	NOMB.=s|GENRE=f|CAS=r
se	se	CONsub	MORPH=empty
mon	mon1	DETpos	PERS.=1|NOMB.=s|GENRE=m|CAS=r
comant	comant	NOMcom	NOMB.=s|GENRE=m|CAS=r
del	de+le	PRE.DETdef	MORPH=empty+NOMB.=s|GENRE=m|CAS=r
tot	tot	PROind	NOMB.=s|GENRE=m|CAS=r
ne	ne1	ADVneg	MORPH=empty
font	faire	VERcjg	MODE=ind|TEMPS=pst|PERS.=3|NOMB.=p
Atant	atant	ADVgen	DEGRE=-
l	il	PROper	PERS.=3|NOMB.=s|GENRE=m|CAS=i
ont	avoir	VERcjg	MODE=ind|TEMPS=pst|PERS.=3|NOMB.=p
encliné	encliner	VERppe	NOMB.=s|GENRE=m|CAS=r
parfont	parfont	ADJqua	NOMB.=s|GENRE=m|CAS=r|DEGRE=p
cele	cel	DETdem	NOMB.=s|GENRE=f|CAS=n
gent	gent1	NOMcom	NOMB.=s|GENRE=f|CAS=n
honteuse	hontos	ADJqua	NOMB.=s|GENRE=f|CAS=n|DEGRE=p
et	et	CONcoo	MORPH=empty
despite	despire	VERppe	NOMB.=s|GENRE=f|CAS=n
Sire	seignor	NOMcom	NOMB.=s|GENRE=m|CAS=n
font	faire	VERcjg	MODE=ind|TEMPS=pst|PERS.=3|NOMB.=p
il	il	PROper	PERS.=3|NOMB.=p|GENRE=m|CAS=n
ta	ton4	DETpos	PERS.=2|NOMB.=s|GENRE=f|CAS=r
loi	loi3	NOMcom	NOMB.=s|GENRE=f|CAS=r
escripte	escrire	VERppe	NOMB.=s|GENRE=f|CAS=r
nos	nos1	PROper	PERS.=1|NOMB.=p|GENRE=m|CAS=i
fai	faire	VERcjg	MODE=imp|PERS.=2|NOMB.=s
avoir	avoir	VERinf	MORPH=empty
et	et	CONcoo	MORPH=empty
signorie	seignorie	NOMcom	NOMB.=s|GENRE=f|CAS=r
par	par	PRE	MORPH=empty
coi	coi2	PROrel	NOMB.=s|GENRE=n|CAS=r
nus	nul	DETind	PERS.=1|NOMB.=s|GENRE=m|CAS=n
hom	ome	NOMcom	NOMB.=s|GENRE=m|CAS=n
ne	ne1	ADVneg	MORPH=empty
nous	nos1	PROper	PERS.=1|NOMB.=p|GENRE=m|CAS=r
puist	pöoir	VERcjg	MODE=sub|TEMPS=ipf|PERS.=3|NOMB.=s
mie	mie	ADVneg	MORPH=empty
sosmetre	sosmetre1	VERinf	MORPH=empty
de	de	PRE	MORPH=empty
no	nostre	DETpos	PERS.=1|NOMB.=s|GENRE=f|CAS=r
volenté	volenté	NOMcom	NOMB.=s|GENRE=f|CAS=r
Et	et	CONcoo	MORPH=empty
nous	nos1	PROper	PERS.=1|NOMB.=p|GENRE=m|CAS=n
de	de	PRE	MORPH=empty
toi	tu	PROper	PERS.=2|NOMB.=s|GENRE=m|CAS=r
ferons	faire	VERcjg	MODE=ind|TEMPS=fut|PERS.=1|NOMB.=p
no	nostre	DETpos	PERS.=1|NOMB.=s|GENRE=m|CAS=r
dé	dieu	NOMcom	NOMB.=s|GENRE=m|CAS=r
car	car	CONcoo	MORPH=empty
bien	bien1	ADVgen	DEGRE=p
veons	vëoir	VERcjg	MODE=ind|TEMPS=pst|PERS.=1|NOMB.=p
et	et	CONcoo	MORPH=empty
s	si	ADVgen	DEGRE=-
est	estre1	VERcjg	MODE=ind|TEMPS=pst|PERS.=3|NOMB.=s
tos	tot	ADVgen	NOMB.=s|GENRE=m|CAS=n
voirs	voir	ADJqua	NOMB.=s|GENRE=m|CAS=n|DEGRE=p
que	que4	CONsub	MORPH=empty
par	par2	ADVgen	MORPH=empty
si	si	ADVgen	DEGRE=-
est	estre1	VERcjg	MODE=ind|TEMPS=pst|PERS.=3|NOMB.=s
grans	grant	ADJqua	NOMB.=s|GENRE=m|CAS=n|DEGRE=p
ses	son4	DETpos	PERS.=3|NOMB.=s|GENRE=m|CAS=n
savoirs	savoir	NOMcom	NOMB.=s|GENRE=m|CAS=n
