form	lemma	POS	morph
Et	et	CONcoo	MORPH=empty
li	le	DETdef	NOMB.=s|GENRE=f|CAS=n
pucelle	pucele	NOMcom	NOMB.=s|GENRE=f|CAS=n
el	en1+le	PRE.DETdef	MORPH=empty+NOMB.=s|GENRE=m|CAS=r
destre	destre	ADJqua	NOMB.=s|GENRE=m|CAS=r|DEGRE=p
surcil	sorcil	NOMcom	NOMB.=s|GENRE=m|CAS=r
honteose	hontos	ADJqua	NOMB.=s|GENRE=f|CAS=r|DEGRE=p
utele	utile	ADJqua	NOMB.=s|GENRE=f|CAS=n|DEGRE=p
se	se	CONsub	MORPH=empty
el	il	PROper	PERS.=3|NOMB.=s|GENRE=f|CAS=n
at	a3	PRE	MORPH=empty
home	ome	NOMcom	NOMB.=s|GENRE=m|CAS=r
amee	amer1	VERppe	NOMB.=s|GENRE=f|CAS=n
en	en2	PROadv	MORPH=empty
iert	estre1	VERcjg	MODE=ind|TEMPS=fut|PERS.=3|NOMB.=s
Enfers	enfer	NOMcom	NOMB.=s|GENRE=m|CAS=n
toust	tost1	ADVgen	DEGRE=p
morat	morir	VERcjg	MODE=ind|TEMPS=fut|PERS.=3|NOMB.=s
Soinge	soing	NOMcom	NOMB.=s|GENRE=m|CAS=n
toust	tost1	ADVgen	DEGRE=p
serat	estre1	VERcjg	MODE=ind|TEMPS=fut|PERS.=3|NOMB.=s
fais	faire	VERppe	NOMB.=s|GENRE=m|CAS=n
à	a3	PRE	MORPH=empty
Deu	Dieu	NOMpro	NOMB.=s|GENRE=m|CAS=r
le	il	PROper	PERS.=3|NOMB.=s|GENRE=m|CAS=r
commande	comander	VERcjg	MODE=ind|TEMPS=pst|PERS.=3|NOMB.=s
Lune	lune	NOMcom	NOMB.=s|GENRE=f|CAS=n
ix	9	PROcar	NOMB.=s|GENRE=m|CAS=n
Li	le	DETdef	NOMB.=s|GENRE=f|CAS=n
novemes	novaine	NOMcom	NOMB.=s|GENRE=f|CAS=n
de	de	PRE	MORPH=empty
totes	tot	DETind	NOMB.=p|GENRE=f|CAS=r
choses	chose	NOMcom	NOMB.=p|GENRE=f|CAS=r
faire	faire	VERinf	MORPH=empty
est	estre1	VERcjg	MODE=ind|TEMPS=pst|PERS.=3|NOMB.=s
bune	bon	ADJqua	NOMB.=s|GENRE=f|CAS=n|DEGRE=p
Fuitous	fuitif	NOMcom	NOMB.=s|GENRE=m|CAS=n
est	estre1	VERcjg	MODE=ind|TEMPS=pst|PERS.=3|NOMB.=s
trovez	trover	VERppe	NOMB.=s|GENRE=m|CAS=n
malades	malade	ADJqua	NOMB.=s|GENRE=m|CAS=n|DEGRE=p
toust	tost1	ADVgen	DEGRE=p
garist	garir	VERcjg	MODE=ind|TEMPS=pst|PERS.=3|NOMB.=s
Enfes	enfant	NOMcom	NOMB.=s|GENRE=m|CAS=n
ki	qui	PROrel	NOMB.=s|GENRE=m|CAS=n
naist	naistre	VERcjg	MODE=ind|TEMPS=pst|PERS.=3|NOMB.=s
voiseus	vezïos	ADJqua	NOMB.=s|GENRE=m|CAS=n|DEGRE=p
glorious	glorïos	ADJqua	NOMB.=s|GENRE=m|CAS=n|DEGRE=p
clers	cler	ADJqua	NOMB.=s|GENRE=m|CAS=n|DEGRE=p
de	de	PRE	MORPH=empty
bunes	bone	NOMcom	NOMB.=p|GENRE=f|CAS=r
gratieus	gracïos	ADJqua	NOMB.=s|GENRE=m|CAS=n|DEGRE=p
de	de	PRE	MORPH=empty
ci	ci	ADVgen	DEGRE=-
à	a3	PRE	MORPH=empty
uit	uit	DETcar	NOMB.=p|GENRE=m|CAS=r
anz	an	NOMcom	NOMB.=p|GENRE=m|CAS=r
perilhous	perillos	ADJqua	NOMB.=s|GENRE=m|CAS=n|DEGRE=p
enseingne	enseigne	NOMcom	NOMB.=s|GENRE=f|CAS=r
à	a3	PRE	MORPH=empty
le	le	DETdef	NOMB.=s|GENRE=f|CAS=r
destre	destre	ADJqua	NOMB.=s|GENRE=f|CAS=r|DEGRE=p
main	main2	NOMcom	NOMB.=s|GENRE=f|CAS=r
s	se	CONsub	MORPH=empty
il	il	PROper	PERS.=3|NOMB.=s|GENRE=m|CAS=n
vit	vivre1	VERcjg	MODE=ind|TEMPS=pst|PERS.=3|NOMB.=s
xxx	30	DETcar	NOMB.=p|GENRE=m|CAS=r
ans	an	NOMcom	NOMB.=p|GENRE=m|CAS=r
rices	riche	ADJqua	NOMB.=s|GENRE=m|CAS=n|DEGRE=p
iert	estre1	VERcjg	MODE=ind|TEMPS=fut|PERS.=3|NOMB.=s
Pucelle	pucele	NOMcom	NOMB.=s|GENRE=f|CAS=n
nee	naistre	VERppe	NOMB.=s|GENRE=f|CAS=n
iert	estre1	VERcjg	MODE=ind|TEMPS=fut|PERS.=3|NOMB.=s
bien	bien1	ADVgen	DEGRE=p
aprise	aprendre	VERppe	NOMB.=s|GENRE=f|CAS=n
plaisencible	plaisancible	ADJqua	NOMB.=s|GENRE=f|CAS=n|DEGRE=p
utelle	utile	ADJqua	NOMB.=s|GENRE=f|CAS=n|DEGRE=p
caste	chaste	ADJqua	NOMB.=s|GENRE=f|CAS=n|DEGRE=p
enseingne	enseigne	NOMcom	NOMB.=s|GENRE=f|CAS=r
at	avoir	VERcjg	MODE=ind|TEMPS=pst|PERS.=3|NOMB.=s
en	en1	PRE	MORPH=empty
la	le	DETdef	NOMB.=s|GENRE=f|CAS=r
destre	destre	ADJqua	NOMB.=s|GENRE=f|CAS=r|DEGRE=p
main	main2	NOMcom	NOMB.=s|GENRE=f|CAS=r
Soinges	soing	NOMcom	NOMB.=s|GENRE=m|CAS=n
at	avoir	VERcjg	MODE=ind|TEMPS=pst|PERS.=3|NOMB.=s
profit	porfit2	NOMcom	NOMB.=s|GENRE=m|CAS=r
nel	ne1+il	ADVneg.PROper	MORPH=empty+PERS.=3|NOMB.=s|GENRE=n|CAS=r
vel	voloir	VERcjg	MODE=ind|TEMPS=pst|PERS.=1|NOMB.=s
diere	dire	VERinf	MORPH=empty
pas	pas	ADVneg	MORPH=empty
Li	le	DETdef	NOMB.=p|GENRE=f|CAS=n
lune	lune	NOMcom	NOMB.=s|GENRE=f|CAS=n
x	10	PROcar	NOMB.=p|GENRE=m|CAS=n
