form	lemma	POS	morph
donai	doner	VERcjg	MODE=ind|TEMPS=psp|PERS.=1|NOMB.=s
quidai	cuidier1	VERcjg	MODE=ind|TEMPS=psp|PERS.=1|NOMB.=s
bien	bien2	NOMcom	NOMB.=s|GENRE=m|CAS=r
faire	faire	VERinf	MORPH=empty
mis	metre2	VERcjg	MODE=ind|TEMPS=psp|PERS.=1|NOMB.=s
pecchié	pechié	NOMcom	NOMB.=s|GENRE=m|CAS=r
pois	pöoir	VERcjg	MODE=ind|TEMPS=pst|PERS.=1|NOMB.=s
retraire	retraire	VERinf	MORPH=empty
fui	estre1	VERcjg	MODE=ind|TEMPS=psp|PERS.=1|NOMB.=s
Criator	crïator	NOMcom	NOMB.=s|GENRE=m|CAS=r
encliné	encliner	VERppe	NOMB.=s|GENRE=f|CAS=r
tien	tenir1	VERcjg	MODE=ind|TEMPS=pst|PERS.=1|NOMB.=s
sire	seignor	NOMcom	NOMB.=s|GENRE=m|CAS=n
discipline	descepline	NOMcom	NOMB.=s|GENRE=f|CAS=r
mesfesis	mesfaire	VERcjg	MODE=ind|TEMPS=psp|PERS.=2|NOMB.=s
sui	estre1	VERcjg	MODE=ind|TEMPS=pst|PERS.=1|NOMB.=s
racine	racine	NOMcom	NOMB.=s|GENRE=f|CAS=n
mal	mal1	NOMcom	NOMB.=s|GENRE=m|CAS=r
est	estre1	VERcjg	MODE=ind|TEMPS=pst|PERS.=3|NOMB.=s
mescine	mecine	NOMcom	NOMB.=s|GENRE=f|CAS=n
mesfait	mesfait	NOMcom	NOMB.=s|GENRE=m|CAS=r
grant	grant	ADJqua	NOMB.=s|GENRE=f|CAS=r|DEGRE=p
mesaventure	mesaventure	NOMcom	NOMB.=s|GENRE=f|CAS=r
compera	comparer2	VERcjg	MODE=ind|TEMPS=fut|PERS.=3|NOMB.=s
engendreore	engendrëure	NOMcom	NOMB.=s|GENRE=f|CAS=r
fruiz	fruit	NOMcom	NOMB.=s|GENRE=m|CAS=n
fu	estre1	VERcjg	MODE=ind|TEMPS=psp|PERS.=3|NOMB.=s
dulz	douz	ADJqua	NOMB.=s|GENRE=m|CAS=n|DEGRE=p
paine	peine	NOMcom	NOMB.=s|GENRE=f|CAS=n
est	estre1	VERcjg	MODE=ind|TEMPS=pst|PERS.=3|NOMB.=s
dure	dur	ADJqua	NOMB.=s|GENRE=f|CAS=n|DEGRE=p
fu	estre1	VERcjg	MODE=ind|TEMPS=psp|PERS.=3|NOMB.=s
mangiez	mangier	VERppe	NOMB.=s|GENRE=m|CAS=n
iert	estre1	VERcjg	MODE=ind|TEMPS=fut|PERS.=3|NOMB.=s
fraiture	fraiture	NOMcom	NOMB.=s|GENRE=f|CAS=n
est	estre1	VERcjg	MODE=ind|TEMPS=pst|PERS.=3|NOMB.=s
sperance	esperance	NOMcom	NOMB.=s|GENRE=f|CAS=n
mesfait	mesfait	NOMcom	NOMB.=s|GENRE=m|CAS=r
char	char2	NOMcom	NOMB.=s|GENRE=f|CAS=n
iert	estre1	VERcjg	MODE=ind|TEMPS=fut|PERS.=3|NOMB.=s
acordance	acordance	NOMcom	NOMB.=s|GENRE=f|CAS=n
rendra	rendre	VERcjg	MODE=ind|TEMPS=fut|PERS.=3|NOMB.=s
grace	grace	NOMcom	NOMB.=s|GENRE=f|CAS=r
mustrance	mostrance	NOMcom	NOMB.=s|GENRE=f|CAS=r
gieter	jeter	VERinf	MORPH=empty
voldra	voloir	VERcjg	MODE=ind|TEMPS=fut|PERS.=3|NOMB.=s
emfer	enfer	NOMcom	NOMB.=s|GENRE=m|CAS=r
pussance	poissance	NOMcom	NOMB.=s|GENRE=f|CAS=r
Frere	frere	NOMcom	NOMB.=s|GENRE=m|CAS=n
sumes	estre1	VERcjg	MODE=ind|TEMPS=pst|PERS.=1|NOMB.=p
germain	germain	ADJqua	NOMB.=s|GENRE=m|CAS=n|DEGRE=p
voelt	voloir	VERcjg	MODE=ind|TEMPS=pst|PERS.=3|NOMB.=s
oir	öir	VERinf	MORPH=empty
merveille	merveille	NOMcom	NOMB.=s|GENRE=f|CAS=r
apareille	apareillier1	VERcjg	MODE=ind|TEMPS=pst|PERS.=3|NOMB.=s
dresce	drecier	VERcjg	MODE=sub|TEMPS=pst|PERS.=3|NOMB.=s
chief	chief1	NOMcom	NOMB.=s|GENRE=m|CAS=r
esgard	esgarder	VERcjg	MODE=sub|TEMPS=pst|PERS.=3|NOMB.=s
dirra	dire	VERcjg	MODE=ind|TEMPS=fut|PERS.=1|NOMB.=s
pard	part1	NOMcom	NOMB.=s|GENRE=f|CAS=r
vendra	venir	VERcjg	MODE=ind|TEMPS=fut|PERS.=3|NOMB.=s
grant	grant	ADJqua	NOMB.=s|GENRE=f|CAS=n|DEGRE=p
mesaventure	mesaventure	NOMcom	NOMB.=s|GENRE=f|CAS=n
passera	passer1	VERcjg	MODE=ind|TEMPS=fut|PERS.=3|NOMB.=s
mesure	mesure	NOMcom	NOMB.=s|GENRE=f|CAS=r
escotez	escouter	VERcjg	MODE=imp|PERS.=2|NOMB.=p
jornee	jornee	NOMcom	NOMB.=s|GENRE=f|CAS=r
doit	devoir	VERcjg	MODE=ind|TEMPS=pst|PERS.=3|NOMB.=s
estre	estre1	VERinf	MORPH=empty
redotee	redoter1	VERppe	NOMB.=s|GENRE=f|CAS=n
ciel	ciel	NOMcom	NOMB.=s|GENRE=m|CAS=r
cherra	chëoir	VERcjg	MODE=ind|TEMPS=fut|PERS.=3|NOMB.=s
pluie	pluie	NOMcom	NOMB.=s|GENRE=f|CAS=n
sanglante	sanglent	ADJqua	NOMB.=s|GENRE=f|CAS=n|DEGRE=p
quidez	cuidier1	VERcjg	MODE=imp|PERS.=2|NOMB.=p
mente	mentir	VERcjg	MODE=sub|TEMPS=pst|PERS.=1|NOMB.=s
terre	terre	NOMcom	NOMB.=s|GENRE=f|CAS=n
iert	estre1	VERcjg	MODE=ind|TEMPS=fut|PERS.=3|NOMB.=s
coloree	colorer	VERppe	NOMB.=s|GENRE=f|CAS=n
avra	avoir	VERcjg	MODE=ind|TEMPS=fut|PERS.=3|NOMB.=s
aspre	aspre	ADJqua	NOMB.=s|GENRE=f|CAS=r|DEGRE=p
rosee	rosee2	NOMcom	NOMB.=s|GENRE=f|CAS=r
emfant	enfant	NOMcom	NOMB.=p|GENRE=m|CAS=n
nez	naistre	VERppe	NOMB.=p|GENRE=m|CAS=n
serront	estre1	VERcjg	MODE=ind|TEMPS=fut|PERS.=3|NOMB.=p
ventres	ventre1	NOMcom	NOMB.=p|GENRE=m|CAS=r
crieront	crïer2	VERcjg	MODE=ind|TEMPS=fut|PERS.=3|NOMB.=p
clere	cler	ADJqua	NOMB.=s|GENRE=f|CAS=r|DEGRE=p
voiz	voiz	NOMcom	NOMB.=s|GENRE=f|CAS=r
iert	estre1	VERcjg	MODE=ind|TEMPS=fut|PERS.=3|NOMB.=s
merveilles	merveille	NOMcom	NOMB.=p|GENRE=f|CAS=r
iert	estre1	VERcjg	MODE=ind|TEMPS=fut|PERS.=3|NOMB.=s
fichie	fichier	VERppe	NOMB.=s|GENRE=f|CAS=n
jor	jor	NOMcom	NOMB.=s|GENRE=m|CAS=r
ciel	ciel	NOMcom	NOMB.=s|GENRE=m|CAS=r
chie	chëoir	VERcjg	MODE=ind|TEMPS=pst|PERS.=3|NOMB.=s
corront	corir	VERcjg	MODE=ind|TEMPS=fut|PERS.=3|NOMB.=p
terre	terre	NOMcom	NOMB.=s|GENRE=f|CAS=r
foldre	foudre	NOMcom	NOMB.=s|GENRE=f|CAS=n
deserre	desserrer	VERcjg	MODE=ind|TEMPS=pst|PERS.=3|NOMB.=s
monz	mont	NOMcom	NOMB.=p|GENRE=m|CAS=r
irront	aler	VERcjg	MODE=ind|TEMPS=fut|PERS.=3|NOMB.=p
corant	corir	VERppa	NOMB.=x|GENRE=x|CAS=x
grant	grant	ADJqua	NOMB.=s|GENRE=f|CAS=r|DEGRE=p
lermes	larme	NOMcom	NOMB.=p|GENRE=f|CAS=r
espandant	espandre	VERppa	NOMB.=x|GENRE=x|CAS=x
mot	mot	NOMcom	NOMB.=s|GENRE=m|CAS=r
dirront	dire	VERcjg	MODE=ind|TEMPS=fut|PERS.=3|NOMB.=p
abissme	abisme	NOMcom	NOMB.=s|GENRE=m|CAS=r
descenderont	descendre	VERcjg	MODE=ind|TEMPS=fut|PERS.=3|NOMB.=p
pardu	perdre	VERppe	NOMB.=s|GENRE=m|CAS=r
averont	avoir	VERcjg	MODE=ind|TEMPS=fut|PERS.=3|NOMB.=p
grant	grant	ADJqua	NOMB.=s|GENRE=f|CAS=r|DEGRE=p
clarté	clarté	NOMcom	NOMB.=s|GENRE=f|CAS=r
luisent	luisir	VERcjg	MODE=ind|TEMPS=pst|PERS.=3|NOMB.=p
noit	nuit	NOMcom	NOMB.=s|GENRE=f|CAS=r
esté	esté1	NOMcom	NOMB.=s|GENRE=m|CAS=r
naires	noir	ADJqua	NOMB.=p|GENRE=m|CAS=n|DEGRE=p
serront	estre1	VERcjg	MODE=ind|TEMPS=fut|PERS.=3|NOMB.=p
charbon	charbon	NOMcom	NOMB.=p|GENRE=m|CAS=n
deux	douz	ADJqua	NOMB.=s|GENRE=m|CAS=n|DEGRE=p
from	faire	VERcjg	MODE=ind|TEMPS=fut|PERS.=1|NOMB.=p
somes	estre1	VERcjg	MODE=ind|TEMPS=pst|PERS.=1|NOMB.=p
envolupé	envoleper	VERppe	NOMB.=p|GENRE=m|CAS=n
grant	grant	ADJqua	NOMB.=p|GENRE=m|CAS=r|DEGRE=p
pecchiez	pechié	NOMcom	NOMB.=p|GENRE=m|CAS=r
emvenimé	envenimer	VERppe	NOMB.=p|GENRE=m|CAS=r
