form	lemma	POS	morph
iert	estre1	VERcjg	MODE=ind|TEMPS=fut|PERS.=3|NOMB.=s
fins	fin1	NOMcom	NOMB.=s|GENRE=f|CAS=n
morra	morir	VERcjg	MODE=ind|TEMPS=fut|PERS.=3|NOMB.=s
repairera	repairier	VERcjg	MODE=ind|TEMPS=fut|PERS.=3|NOMB.=s
demora	demorer	VERcjg	MODE=ind|TEMPS=psp|PERS.=3|NOMB.=s
meis	mois2	NOMcom	NOMB.=s|GENRE=m|CAS=r
grant	grant	ADJqua	NOMB.=s|GENRE=f|CAS=r|DEGRE=p
feste	feste1	NOMcom	NOMB.=s|GENRE=f|CAS=r
fist	faire	VERcjg	MODE=ind|TEMPS=psp|PERS.=3|NOMB.=s
reis	roi2	NOMcom	NOMB.=s|GENRE=m|CAS=n
Granz	grant	ADJqua	NOMB.=s|GENRE=f|CAS=n|DEGRE=p
fu	estre1	VERcjg	MODE=ind|TEMPS=psp|PERS.=3|NOMB.=s
corz	cort1	NOMcom	NOMB.=s|GENRE=f|CAS=n
ajosta	ajoster	VERcjg	MODE=ind|TEMPS=psp|PERS.=3|NOMB.=s
granz	grant	ADJqua	NOMB.=s|GENRE=f|CAS=n|DEGRE=p
genz	gent1	NOMcom	NOMB.=s|GENRE=f|CAS=n
asenbla	assembler	VERcjg	MODE=ind|TEMPS=psp|PERS.=3|NOMB.=s
ot	avoir	VERcjg	MODE=ind|TEMPS=psp|PERS.=3|NOMB.=s
contes	conte1	NOMcom	NOMB.=p|GENRE=m|CAS=r
dus	duc2	NOMcom	NOMB.=p|GENRE=m|CAS=r
chevaliers	chevalier	NOMcom	NOMB.=p|GENRE=m|CAS=r
fu	estre1	VERcjg	MODE=ind|TEMPS=psp|PERS.=3|NOMB.=s
sostint	sostenir	VERcjg	MODE=ind|TEMPS=psp|PERS.=3|NOMB.=s
pesant	pesant	ADJqua	NOMB.=s|GENRE=m|CAS=r|DEGRE=p
fais	fait1	NOMcom	NOMB.=p|GENRE=m|CAS=r
grant	grant	ADJqua	NOMB.=s|GENRE=f|CAS=r|DEGRE=p
merveille	merveille	NOMcom	NOMB.=s|GENRE=f|CAS=r
fist	faire	VERcjg	MODE=ind|TEMPS=psp|PERS.=3|NOMB.=s
felon	felon	ADJqua	NOMB.=s|GENRE=m|CAS=r|DEGRE=p
jaiant	jaiant	NOMcom	NOMB.=s|GENRE=m|CAS=r
ocist	ocire	VERcjg	MODE=ind|TEMPS=psp|PERS.=3|NOMB.=s
bones	bone	NOMcom	NOMB.=p|GENRE=f|CAS=r
ficha	fichier	VERcjg	MODE=ind|TEMPS=psp|PERS.=3|NOMB.=s
trova	trover	VERcjg	MODE=ind|TEMPS=psp|PERS.=3|NOMB.=s
granz	grant	ADJqua	NOMB.=p|GENRE=f|CAS=r|DEGRE=p
merveilles	merveille	NOMcom	NOMB.=p|GENRE=f|CAS=r
fait	faire	VERcjg	MODE=ind|TEMPS=pst|PERS.=3|NOMB.=s
anz	an	NOMcom	NOMB.=p|GENRE=m|CAS=r
verra	vëoir	VERcjg	MODE=ind|TEMPS=fut|PERS.=3|NOMB.=s
jor	jor	NOMcom	NOMB.=s|GENRE=m|CAS=r
païs	päis	NOMcom	NOMB.=s|GENRE=m|CAS=r
arriverons	ariver1	VERcjg	MODE=ind|TEMPS=fut|PERS.=1|NOMB.=s
congié	congié	NOMcom	NOMB.=s|GENRE=m|CAS=r
querrons	querre	VERcjg	MODE=ind|TEMPS=fut|PERS.=1|NOMB.=s
vie	vie1	NOMcom	NOMB.=s|GENRE=f|CAS=r
manace	menace	NOMcom	NOMB.=s|GENRE=f|CAS=r
seit	estre1	VERcjg	MODE=sub|TEMPS=pst|PERS.=3|NOMB.=s
desplace	desplaire	VERcjg	MODE=sub|TEMPS=pst|PERS.=3|NOMB.=s
laisserons	laissier	VERcjg	MODE=ind|TEMPS=fut|PERS.=1|NOMB.=p
sojorner	sejorner	VERinf	MORPH=empty
Enuier	enoiier	VERinf	MORPH=empty
deit	devoir	VERcjg	MODE=ind|TEMPS=pst|PERS.=3|NOMB.=s
peser	peser	VERinf	MORPH=empty
honte	honte	NOMcom	NOMB.=s|GENRE=f|CAS=r
a	avoir	VERcjg	MODE=ind|TEMPS=pst|PERS.=3|NOMB.=s
fait	faire	VERppe	NOMB.=s|GENRE=m|CAS=r
Moü	movoir	VERppe	NOMB.=s|GENRE=m|CAS=r
devreit	devoir	VERcjg	MODE=con|PERS.=3|NOMB.=s
aveir	avoir	VERinf	MORPH=empty
plait	plait	NOMcom	NOMB.=s|GENRE=m|CAS=r
tornast	torner	VERcjg	MODE=sub|TEMPS=ipf|PERS.=3|NOMB.=s
deshonor	desonor	NOMcom	NOMB.=s|GENRE=x|CAS=r
venist	venir	VERcjg	MODE=sub|TEMPS=ipf|PERS.=3|NOMB.=s
chief	chief1	NOMcom	NOMB.=s|GENRE=m|CAS=r
tor	tor5	NOMcom	NOMB.=s|GENRE=m|CAS=r
jorz	jor	NOMcom	NOMB.=p|GENRE=m|CAS=r
poüst	pöoir	VERcjg	MODE=sub|TEMPS=ipf|PERS.=3|NOMB.=s
plaindre	plaindre	VERinf	MORPH=empty
fera	faire	VERcjg	MODE=ind|TEMPS=fut|PERS.=3|NOMB.=s
puet	pöoir	VERcjg	MODE=ind|TEMPS=pst|PERS.=3|NOMB.=s
remaindre	remanoir	VERinf	MORPH=empty
messages	message2	NOMcom	NOMB.=s|GENRE=m|CAS=n
fu	estre1	VERcjg	MODE=ind|TEMPS=psp|PERS.=3|NOMB.=s
corteis	cortois	ADJqua	NOMB.=s|GENRE=m|CAS=n|DEGRE=p
seignor	seignor	NOMcom	NOMB.=p|GENRE=m|CAS=n
fait	faire	VERcjg	MODE=ind|TEMPS=pst|PERS.=3|NOMB.=s
laide	lait1	ADJqua	NOMB.=s|GENRE=f|CAS=n|DEGRE=p
chose	chose	NOMcom	NOMB.=s|GENRE=f|CAS=n
est	estre1	VERcjg	MODE=ind|TEMPS=pst|PERS.=3|NOMB.=s
manacier	menacier	VERinf	MORPH=empty
