form	lemma	POS	morph
Dux	duc2	NOMcom	NOMB.=s|GENRE=m|CAS=n
sachiez	savoir	VERcjg	MODE=imp|PERS.=2|NOMB.=p
dotance	dotance	NOMcom	NOMB.=s|GENRE=f|CAS=r
plore	plorer	VERcjg	MODE=ind|TEMPS=pst|PERS.=3|NOMB.=s
set	savoir	VERcjg	MODE=ind|TEMPS=pst|PERS.=3|NOMB.=s
grant	grant	ADJqua	NOMB.=s|GENRE=m|CAS=r|DEGRE=p
duel	duel	NOMcom	NOMB.=s|GENRE=m|CAS=r
ai	avoir	VERcjg	MODE=ind|TEMPS=pst|PERS.=1|NOMB.=s
ai	avoir	VERcjg	MODE=ind|TEMPS=pst|PERS.=1|NOMB.=s
cuer	cuer2	NOMcom	NOMB.=s|GENRE=m|CAS=r
marri	marrir	VERppe	NOMB.=s|GENRE=m|CAS=r
oir	oir	NOMcom	NOMB.=s|GENRE=m|CAS=r
a	avoir	VERcjg	MODE=ind|TEMPS=pst|PERS.=3|NOMB.=s
duc	duc2	NOMcom	NOMB.=s|GENRE=m|CAS=r
devroit	devoir	VERcjg	MODE=con|PERS.=3|NOMB.=s
amander	amender	VERinf	MORPH=empty
os	oser	VERcjg	MODE=ind|TEMPS=pst|PERS.=1|NOMB.=s
comander	comander	VERinf	MORPH=empty
est	estre1	VERcjg	MODE=ind|TEMPS=pst|PERS.=3|NOMB.=s
biens	bien2	NOMcom	NOMB.=s|GENRE=m|CAS=n
effaciez	esfacier	VERppe	NOMB.=s|GENRE=m|CAS=n
doit	devoir	VERcjg	MODE=ind|TEMPS=pst|PERS.=3|NOMB.=s
estre	estre1	VERinf	MORPH=empty
anonciez	anoncier	VERppe	NOMB.=s|GENRE=m|CAS=n
ert	estre1	VERcjg	MODE=ind|TEMPS=fut|PERS.=3|NOMB.=s
ramanteuz	ramentevoir	VERppe	NOMB.=s|GENRE=m|CAS=n
est	estre1	VERcjg	MODE=ind|TEMPS=pst|PERS.=3|NOMB.=s
biens	bien2	NOMcom	NOMB.=s|GENRE=m|CAS=n
veuz	vÃ«oir	VERppe	NOMB.=s|GENRE=m|CAS=n
doie	devoir	VERcjg	MODE=sub|TEMPS=pst|PERS.=1|NOMB.=s
ramantoivre	rementevoir	VERinf	MORPH=empty
fuelles	fueille	NOMcom	NOMB.=p|GENRE=f|CAS=r
genoivre	genoivre	NOMcom	NOMB.=s|GENRE=m|CAS=r
jor	jor	NOMcom	NOMB.=s|GENRE=m|CAS=r
vivant	vivre1	VERppa	NOMB.=s|GENRE=m|CAS=r
