form	lemma	POS	morph
bestes	beste	NOMcom	NOMB.=p|GENRE=f|CAS=r
assembla	assembler	VERcjg	MODE=ind|TEMPS=psp|PERS.=3|NOMB.=s
oysiaux	oisel	NOMcom	NOMB.=p|GENRE=m|CAS=r
manda	mander	VERcjg	MODE=ind|TEMPS=psp|PERS.=3|NOMB.=s
a	avoir	VERcjg	MODE=ind|TEMPS=pst|PERS.=3|NOMB.=s
fait	faire	VERppe	NOMB.=s|GENRE=m|CAS=r
demander	demander	VERinf	MORPH=empty
scet	savoir	VERcjg	MODE=ind|TEMPS=pst|PERS.=3|NOMB.=s
mediciner	medeciner	VERinf	MORPH=empty
ont	avoir	VERcjg	MODE=ind|TEMPS=pst|PERS.=3|NOMB.=p
conseil	conseil	NOMcom	NOMB.=s|GENRE=m|CAS=r
priis	prendre	VERppe	NOMB.=s|GENRE=m|CAS=r
dist	dire	VERcjg	MODE=ind|TEMPS=psp|PERS.=3|NOMB.=s
avis	avis	NOMcom	NOMB.=s|GENRE=m|CAS=r
grüe	grue	NOMcom	NOMB.=s|GENRE=f|CAS=n
dient	dire	VERcjg	MODE=ind|TEMPS=pst|PERS.=3|NOMB.=p
a	avoir	VERcjg	MODE=ind|TEMPS=pst|PERS.=3|NOMB.=s
sache	sachier2	VERcjg	MODE=sub|TEMPS=pst|PERS.=3|NOMB.=s
col	col	NOMcom	NOMB.=s|GENRE=m|CAS=r
a	avoir	VERcjg	MODE=ind|TEMPS=pst|PERS.=3|NOMB.=s
long	lonc	ADJqua	NOMB.=s|GENRE=m|CAS=r|DEGRE=p
bec	bec	NOMcom	NOMB.=s|GENRE=m|CAS=r
gros	gros	ADJqua	NOMB.=s|GENRE=m|CAS=r|DEGRE=p
pourroit	pöoir	VERcjg	MODE=con|PERS.=3|NOMB.=s
traire	traire	VERinf	MORPH=empty
os	os2	NOMcom	NOMB.=s|GENRE=m|CAS=r
leu	lou	NOMcom	NOMB.=s|GENRE=m|CAS=n
promist	prometre	VERcjg	MODE=ind|TEMPS=psp|PERS.=3|NOMB.=s
grant	grant	ADJqua	NOMB.=s|GENRE=m|CAS=r|DEGRE=p
louier	loiier	NOMcom	NOMB.=s|GENRE=m|CAS=r
voulsist	voloir	VERcjg	MODE=sub|TEMPS=ipf|PERS.=3|NOMB.=s
aidier	aidier	VERinf	MORPH=empty
grüe	grue	NOMcom	NOMB.=s|GENRE=f|CAS=n
lance	lancier3	VERcjg	MODE=ind|TEMPS=pst|PERS.=3|NOMB.=s
bec	bec	NOMcom	NOMB.=s|GENRE=m|CAS=r
gueule	gole	NOMcom	NOMB.=s|GENRE=f|CAS=r
malfaisant	maufaisant	NOMcom	NOMB.=s|GENRE=m|CAS=r
os	os2	NOMcom	NOMB.=s|GENRE=m|CAS=r
a	avoir	VERcjg	MODE=ind|TEMPS=pst|PERS.=3|NOMB.=s
trait	trait	NOMcom	NOMB.=s|GENRE=m|CAS=r
requist	requerre	VERcjg	MODE=ind|TEMPS=psp|PERS.=3|NOMB.=s
pourrez	pöoir	VERcjg	MODE=ind|TEMPS=fut|PERS.=2|NOMB.=p
ayde	äie	NOMcom	NOMB.=s|GENRE=f|CAS=r
hault	haut	NOMcom	NOMB.=s|GENRE=m|CAS=r
monter	monter	VERinf	MORPH=empty
aiez	avoir	VERcjg	MODE=imp|PERS.=2|NOMB.=p
hyde	hisde	NOMcom	NOMB.=s|GENRE=f|CAS=r
voulray	voloir	VERcjg	MODE=con|PERS.=1|NOMB.=s
pourveir	porvëoir	VERinf	MORPH=empty
souriz	soriz	NOMcom	NOMB.=p|GENRE=f|CAS=r
faire	faire	VERinf	MORPH=empty
venir	venir	VERinf	MORPH=empty
cordage	cordage	NOMcom	NOMB.=s|GENRE=m|CAS=r
despecier	depecier	VERinf	MORPH=empty
roysieux	rosel	NOMcom	NOMB.=p|GENRE=m|CAS=r
enpeschier	empëechier	VERinf	MORPH=empty
pourroient	pöoir	VERcjg	MODE=con|PERS.=3|NOMB.=p
issir	issir	NOMcom	NOMB.=x|GENRE=x|CAS=x
soiez	estre1	VERcjg	MODE=imp|PERS.=2|NOMB.=p
recors	recort1	ADJqua	NOMB.=s|GENRE=m|CAS=n|DEGRE=p
enseignement	enseignement	NOMcom	NOMB.=s|GENRE=m|CAS=n
souriz	soriz	NOMcom	NOMB.=s|GENRE=f|CAS=r
fist	faire	VERcjg	MODE=ind|TEMPS=psp|PERS.=3|NOMB.=s
lion	lïon	NOMcom	NOMB.=s|GENRE=m|CAS=n
fu	estre1	VERcjg	MODE=ind|TEMPS=psp|PERS.=3|NOMB.=s
gueriz	garir	VERppe	NOMB.=s|GENRE=m|CAS=n
fosse	fosse	NOMcom	NOMB.=s|GENRE=f|CAS=r
est	estre1	VERcjg	MODE=ind|TEMPS=pst|PERS.=3|NOMB.=s
eschappez	eschaper	VERppe	NOMB.=s|GENRE=m|CAS=n
valut	valoir	VERcjg	MODE=ind|TEMPS=psp|PERS.=3|NOMB.=s
humilitez	umelité	NOMcom	NOMB.=s|GENRE=f|CAS=n
exemple	essemple	NOMcom	NOMB.=s|GENRE=m|CAS=r
somme	somer	VERcjg	MODE=ind|TEMPS=pst|PERS.=3|NOMB.=s
exemple	essemple	NOMcom	NOMB.=s|GENRE=m|CAS=r
prengnent	prendre	VERcjg	MODE=sub|TEMPS=pst|PERS.=3|NOMB.=p
riche	riche	ADJqua	NOMB.=p|GENRE=m|CAS=n|DEGRE=p
homme	ome	NOMcom	NOMB.=p|GENRE=m|CAS=n
povres	povre	NOMcom	NOMB.=p|GENRE=m|CAS=r
ont	avoir	VERcjg	MODE=ind|TEMPS=pst|PERS.=3|NOMB.=p
povoir	pöoir	NOMcom	NOMB.=s|GENRE=m|CAS=r
