form	lemma	POS	morph
est	estre1	VERcjg	MODE=ind|TEMPS=pst|PERS.=3|NOMB.=s
onur	onor	NOMcom	NOMB.=s|GENRE=x|CAS=n
repeiré	repairier	VERppe	NOMB.=s|GENRE=m|CAS=n
chevalers	chevalier	NOMcom	NOMB.=p|GENRE=m|CAS=n
meisnee	maisniee	NOMcom	NOMB.=s|GENRE=f|CAS=n
reçut	recevoir	VERcjg	MODE=ind|TEMPS=psp|PERS.=3|NOMB.=s
heritage	iretage	NOMcom	NOMB.=s|GENRE=m|CAS=r
set	savoir	VERcjg	MODE=ind|TEMPS=pst|PERS.=3|NOMB.=s
curage	corage	NOMcom	NOMB.=s|GENRE=m|CAS=r
preise	prisier	VERcjg	MODE=ind|TEMPS=pst|PERS.=3|NOMB.=s
terre	terre	NOMcom	NOMB.=s|GENRE=f|CAS=r
honur	onor	NOMcom	NOMB.=s|GENRE=x|CAS=r
turna	torner	VERcjg	MODE=ind|TEMPS=psp|PERS.=3|NOMB.=s
onur	onor	NOMcom	NOMB.=s|GENRE=f|CAS=r
qui	cuidier1	VERcjg	MODE=ind|TEMPS=pst|PERS.=1|NOMB.=s
espeir	esperer	VERcjg	MODE=ind|TEMPS=pst|PERS.=1|NOMB.=s
vodrat	voloir	VERcjg	MODE=ind|TEMPS=fut|PERS.=3|NOMB.=s
feire	faire	VERinf	MORPH=empty
here	oir	NOMcom	NOMB.=s|GENRE=m|CAS=r
remeint	remanoir	VERcjg	MODE=ind|TEMPS=pst|PERS.=3|NOMB.=s
grant	grant	ADJqua	NOMB.=s|GENRE=m|CAS=n|DEGRE=p
heritez	ireté	NOMcom	NOMB.=s|GENRE=m|CAS=n
chastels	chastel	NOMcom	NOMB.=p|GENRE=m|CAS=n
burs	borc	NOMcom	NOMB.=p|GENRE=m|CAS=n
vinnes	vigne1	NOMcom	NOMB.=p|GENRE=f|CAS=n
prez	pré	NOMcom	NOMB.=p|GENRE=m|CAS=n
Or	or1	NOMcom	NOMB.=s|GENRE=m|CAS=n
argent	argent	NOMcom	NOMB.=s|GENRE=m|CAS=n
pailles	paile	NOMcom	NOMB.=p|GENRE=m|CAS=n
cendals	cendal	NOMcom	NOMB.=p|GENRE=m|CAS=n
palefreiz	palefroi	NOMcom	NOMB.=p|GENRE=m|CAS=n
mulz	mul3	NOMcom	NOMB.=p|GENRE=m|CAS=n
bels	bel1	ADJqua	NOMB.=p|GENRE=m|CAS=n|DEGRE=p
chevals	cheval	NOMcom	NOMB.=p|GENRE=m|CAS=n
veissele	vaissele	NOMcom	NOMB.=s|GENRE=f|CAS=n
or	or1	NOMcom	NOMB.=s|GENRE=m|CAS=r
argent	argent	NOMcom	NOMB.=s|GENRE=m|CAS=r
depart	departir	VERcjg	MODE=ind|TEMPS=pst|PERS.=3|NOMB.=s
donout	doner	VERcjg	MODE=ind|TEMPS=ipf|PERS.=3|NOMB.=s
lecheurs	lechëor	NOMcom	NOMB.=p|GENRE=m|CAS=r
Dolenz	dolent	ADJqua	NOMB.=s|GENRE=m|CAS=n|DEGRE=p
fu	estre1	VERcjg	MODE=ind|TEMPS=psp|PERS.=3|NOMB.=s
plure	plorer	VERcjg	MODE=ind|TEMPS=pst|PERS.=3|NOMB.=s
gaimente	gaimenter	VERcjg	MODE=ind|TEMPS=pst|PERS.=3|NOMB.=s
demente	dementer	VERcjg	MODE=ind|TEMPS=pst|PERS.=3|NOMB.=s
feit	faire	VERcjg	MODE=ind|TEMPS=pst|PERS.=3|NOMB.=s
bons	bon	ADJqua	NOMB.=s|GENRE=m|CAS=r|DEGRE=p
rei	roi2	NOMcom	NOMB.=s|GENRE=m|CAS=r
verrai	verai	ADJqua	NOMB.=s|GENRE=m|CAS=r|DEGRE=p
glorius	glorïos	ADJqua	NOMB.=s|GENRE=m|CAS=r|DEGRE=p
pere	pere	NOMcom	NOMB.=s|GENRE=m|CAS=r
ferai	faire	VERcjg	MODE=ind|TEMPS=fut|PERS.=1|NOMB.=s
quid	cuidier1	VERcjg	MODE=ind|TEMPS=pst|PERS.=1|NOMB.=s
sei	savoir	VERcjg	MODE=ind|TEMPS=pst|PERS.=1|NOMB.=s
vai	vëoir	VERcjg	MODE=ind|TEMPS=pst|PERS.=1|NOMB.=s
as	avoir	VERcjg	MODE=ind|TEMPS=pst|PERS.=2|NOMB.=s
cure	cure	NOMcom	NOMB.=s|GENRE=f|CAS=r
gent	gent1	NOMcom	NOMB.=s|GENRE=f|CAS=n
luintaine	lointain	ADJqua	NOMB.=s|GENRE=f|CAS=r|DEGRE=p
terre	terre	NOMcom	NOMB.=s|GENRE=f|CAS=r
venent	venir	VERcjg	MODE=ind|TEMPS=pst|PERS.=3|NOMB.=p
requere	requerre	VERinf	MORPH=empty
pire	pejor	ADJqua	NOMB.=s|GENRE=m|CAS=n|DEGRE=c
maz	mat	ADJqua	NOMB.=s|GENRE=m|CAS=n|DEGRE=p
valt	valoir	VERcjg	MODE=ind|TEMPS=pst|PERS.=3|NOMB.=s
face	faire	VERcjg	MODE=sub|TEMPS=pst|PERS.=1|NOMB.=s
poz	pöoir	VERcjg	MODE=ind|TEMPS=pst|PERS.=2|NOMB.=s
mustrer	mostrer	VERinf	MORPH=empty
bunté	bonté	NOMcom	NOMB.=s|GENRE=f|CAS=r
pleist	plaire	VERcjg	MODE=ind|TEMPS=pst|PERS.=3|NOMB.=s
dunes	doner	VERcjg	MODE=imp|PERS.=2|NOMB.=s
santé	santé	NOMcom	NOMB.=s|GENRE=f|CAS=r
afert	aferir	VERcjg	MODE=ind|TEMPS=pst|PERS.=3|NOMB.=s
sui	estre1	VERcjg	MODE=ind|TEMPS=pst|PERS.=1|NOMB.=s
peccheur	pechëor	NOMcom	NOMB.=s|GENRE=m|CAS=n
dolent	dolent	ADJqua	NOMB.=s|GENRE=m|CAS=n|DEGRE=p
aveie	avoir	VERcjg	MODE=ind|TEMPS=ipf|PERS.=1|NOMB.=s
feit	faire	VERppe	NOMB.=s|GENRE=m|CAS=r
