form	lemma	POS	morph
leverent	lever	VERcjg	MODE=ind|TEMPS=psp|PERS.=3|NOMB.=p
chant	chant2	NOMcom	NOMB.=s|GENRE=m|CAS=r
munt	monde1	NOMcom	NOMB.=s|GENRE=m|CAS=r
medlerent	mesler	VERcjg	MODE=ind|TEMPS=psp|PERS.=3|NOMB.=p
levad	lever	VERcjg	MODE=ind|TEMPS=psp|PERS.=3|NOMB.=s
esturs	estor2	NOMcom	NOMB.=s|GENRE=m|CAS=n
forz	fort	ADJqua	NOMB.=s|GENRE=m|CAS=n|DEGRE=p
fiers	fier	ADJqua	NOMB.=s|GENRE=m|CAS=n|DEGRE=p
entreocieient	entr'ocire	VERcjg	MODE=ind|TEMPS=ipf|PERS.=3|NOMB.=p
fud	estre1	VERcjg	MODE=ind|TEMPS=psp|PERS.=3|NOMB.=s
venuz	venir	VERppe	NOMB.=s|GENRE=m|CAS=n
enemis	enemi	NOMcom	NOMB.=p|GENRE=m|CAS=r
vindrent	venir	VERcjg	MODE=ind|TEMPS=psp|PERS.=3|NOMB.=p
cave	cave2	NOMcom	NOMB.=s|GENRE=f|CAS=r
est	estre1	VERcjg	MODE=ind|TEMPS=pst|PERS.=3|NOMB.=s
desert	desert2	NOMcom	NOMB.=s|GENRE=m|CAS=r
champs	champ	NOMcom	NOMB.=p|GENRE=m|CAS=r
virent	vëoir	VERcjg	MODE=ind|TEMPS=psp|PERS.=3|NOMB.=p
morz	mort	VERppe	NOMB.=p|GENRE=m|CAS=r
gesir	jesir	VERinf	MORPH=empty
navrez	navrer	VERppe	NOMB.=p|GENRE=m|CAS=r
pout	pöoir	VERcjg	MODE=ind|TEMPS=psp|PERS.=3|NOMB.=s
eschaper	eschaper	VERinf	MORPH=empty
apruchad	aprochier	VERcjg	MODE=ind|TEMPS=psp|PERS.=3|NOMB.=s
reis	roi2	NOMcom	NOMB.=s|GENRE=m|CAS=n
ost	ost	NOMcom	NOMB.=s|GENRE=f|CAS=r
volt	voloir	VERcjg	MODE=ind|TEMPS=psp|PERS.=3|NOMB.=s
prist	prendre	VERcjg	MODE=ind|TEMPS=psp|PERS.=3|NOMB.=s
morz	mort2	NOMcom	NOMB.=p|GENRE=m|CAS=r
vifs	vif	NOMcom	NOMB.=p|GENRE=m|CAS=r
out	avoir	VERcjg	MODE=ind|TEMPS=psp|PERS.=3|NOMB.=s
armes	arme	NOMcom	NOMB.=p|GENRE=f|CAS=r
vaissele	vaissele	NOMcom	NOMB.=s|GENRE=f|CAS=r
or	or1	NOMcom	NOMB.=s|GENRE=m|CAS=r
argent	argent	NOMcom	NOMB.=s|GENRE=m|CAS=r
guarnemenz	garnement	NOMcom	NOMB.=p|GENRE=m|CAS=r
jurs	jor	NOMcom	NOMB.=p|GENRE=m|CAS=r
pourent	pöoir	VERcjg	MODE=ind|TEMPS=psp|PERS.=3|NOMB.=p
prendre	prendre	VERinf	MORPH=empty
remuer	remüer	VERinf	MORPH=empty
returnad	retorner	VERcjg	MODE=ind|TEMPS=psp|PERS.=3|NOMB.=s
grant	grant	ADJqua	NOMB.=s|GENRE=f|CAS=r|DEGRE=p
leece	lëece	NOMcom	NOMB.=s|GENRE=f|CAS=r
rendirent	rendre	VERcjg	MODE=ind|TEMPS=psp|PERS.=3|NOMB.=p
grace	grace	NOMcom	NOMB.=s|GENRE=f|CAS=r
loenge	löenge	NOMcom	NOMB.=s|GENRE=f|CAS=r
Seignur	seignor	NOMcom	NOMB.=s|GENRE=m|CAS=r
reis	roi2	NOMcom	NOMB.=s|GENRE=m|CAS=n
fist	faire	VERcjg	MODE=ind|TEMPS=psp|PERS.=3|NOMB.=s
navirie	navílie	NOMcom	NOMB.=s|GENRE=x|CAS=r
faire	faire	VERinf	MORPH=empty
enveier	envoiier	VERinf	MORPH=empty
pur	pur	ADJqua	NOMB.=s|GENRE=m|CAS=r|DEGRE=p
or	or1	NOMcom	NOMB.=s|GENRE=m|CAS=r
parvindrent	parvenir	VERcjg	MODE=ind|TEMPS=psp|PERS.=3|NOMB.=p
depeschiez	despechier	VERppe	NOMB.=p|GENRE=m|CAS=n
furent	estre1	VERcjg	MODE=ind|TEMPS=psp|PERS.=3|NOMB.=p
reis	roi2	NOMcom	NOMB.=s|GENRE=m|CAS=n
requist	requerre	VERcjg	MODE=ind|TEMPS=psp|PERS.=3|NOMB.=s
fud	estre1	VERcjg	MODE=ind|TEMPS=psp|PERS.=3|NOMB.=s
aseurez	assëurer	VERppe	NOMB.=s|GENRE=m|CAS=n
quers	cuer2	NOMcom	NOMB.=s|GENRE=m|CAS=n
eslevad	eslever	VERcjg	MODE=ind|TEMPS=psp|PERS.=3|NOMB.=s
mort	mort	NOMcom	NOMB.=s|GENRE=f|CAS=r
desfaciun	desfaçon	NOMcom	NOMB.=s|GENRE=f|CAS=r
tint	tenir1	VERcjg	MODE=ind|TEMPS=psp|PERS.=3|NOMB.=s
plait	plait	NOMcom	NOMB.=s|GENRE=m|CAS=r
Seignur	seignor	NOMcom	NOMB.=s|GENRE=m|CAS=r
entrad	entrer	VERcjg	MODE=ind|TEMPS=psp|PERS.=3|NOMB.=s
temple	temple1	NOMcom	NOMB.=s|GENRE=m|CAS=r
Seignur	seignor	NOMcom	NOMB.=s|GENRE=m|CAS=r
encens	encens	NOMcom	NOMB.=s|GENRE=m|CAS=r
volt	voloir	VERcjg	MODE=ind|TEMPS=psp|PERS.=3|NOMB.=s
offrir	ofrir	VERinf	MORPH=empty
censier	encensier	NOMcom	NOMB.=s|GENRE=m|CAS=r
altel	autel2	NOMcom	NOMB.=s|GENRE=m|CAS=r
apelad	apeler	VERcjg	MODE=ind|TEMPS=psp|PERS.=3|NOMB.=s
altel	autel2	NOMcom	NOMB.=s|GENRE=m|CAS=r
Thimiame	timïame	NOMcom	NOMB.=s|GENRE=m|CAS=r
esvesches	evesque	NOMcom	NOMB.=s|GENRE=m|CAS=n
pruveires	provoire	NOMcom	NOMB.=p|GENRE=m|CAS=n
pruz	pro	ADJqua	NOMB.=p|GENRE=m|CAS=n|DEGRE=p
vaillanz	vaillant	ADJqua	NOMB.=p|GENRE=m|CAS=n|DEGRE=p
entrerent	entrer	VERcjg	MODE=ind|TEMPS=psp|PERS.=3|NOMB.=p
rei	roi2	NOMcom	NOMB.=s|GENRE=m|CAS=r
esturent	ester	VERcjg	MODE=ind|TEMPS=psp|PERS.=3|NOMB.=p
distrent	dire	VERcjg	MODE=ind|TEMPS=psp|PERS.=3|NOMB.=p
apendeit	apendre	VERcjg	MODE=ind|TEMPS=ipf|PERS.=3|NOMB.=s
faire	faire	VERinf	MORPH=empty
pruveires	provoire	NOMcom	NOMB.=p|GENRE=m|CAS=r
esteient	estre1	VERcjg	MODE=ind|TEMPS=ipf|PERS.=3|NOMB.=p
lignage	lignage	NOMcom	NOMB.=s|GENRE=m|CAS=r
sacrez	sacrer	VERppe	NOMB.=p|GENRE=m|CAS=n
furent	estre1	VERcjg	MODE=ind|TEMPS=psp|PERS.=3|NOMB.=p
servise	servise	NOMcom	NOMB.=s|GENRE=m|CAS=r
faire	faire	VERinf	MORPH=empty
is	issir	VERcjg	MODE=imp|PERS.=2|NOMB.=s
seintuarie	saintüaire	NOMcom	NOMB.=s|GENRE=m|CAS=r
aies	avoir	VERcjg	MODE=imp|PERS.=2|NOMB.=s
despit	despit	NOMcom	NOMB.=s|GENRE=m|CAS=r
afaires	afaire2	NOMcom	NOMB.=s|GENRE=m|CAS=n
revertirad	revertir	VERcjg	MODE=ind|TEMPS=fut|PERS.=3|NOMB.=s
hunur	onor	NOMcom	NOMB.=s|GENRE=x|CAS=r
curechad	corrocier	VERcjg	MODE=ind|TEMPS=psp|PERS.=3|NOMB.=s
pruveires	provoire	NOMcom	NOMB.=p|GENRE=m|CAS=r
tint	tenir1	VERcjg	MODE=ind|TEMPS=psp|PERS.=3|NOMB.=s
encenser	encensoir	NOMcom	NOMB.=s|GENRE=m|CAS=r
puin	poing	NOMcom	NOMB.=s|GENRE=m|CAS=r
maneçout	menacier	VERcjg	MODE=ind|TEMPS=ipf|PERS.=3|NOMB.=s
ferid	ferir	VERcjg	MODE=ind|TEMPS=psp|PERS.=3|NOMB.=s
liepre	liepre	NOMcom	NOMB.=s|GENRE=m|CAS=n
vis	vis1	NOMcom	NOMB.=s|GENRE=m|CAS=r
pruveires	provoire	NOMcom	NOMB.=p|GENRE=m|CAS=r
temple	temple3	NOMcom	NOMB.=s|GENRE=m|CAS=r
autel	autel2	NOMcom	NOMB.=s|GENRE=m|CAS=r
vit	vëoir	VERcjg	MODE=ind|TEMPS=psp|PERS.=3|NOMB.=s
evesches	evesque	NOMcom	NOMB.=s|GENRE=m|CAS=n
pruveire	provoire	NOMcom	NOMB.=p|GENRE=m|CAS=n
chalt	chaut	ADJqua	NOMB.=s|GENRE=m|CAS=r|DEGRE=p
pas	pas	NOMcom	NOMB.=s|GENRE=m|CAS=r
buterent	boter1	VERcjg	MODE=ind|TEMPS=psp|PERS.=3|NOMB.=p
temple	temple3	NOMcom	NOMB.=s|GENRE=m|CAS=r
reis	roi2	NOMcom	NOMB.=s|GENRE=m|CAS=n
fud	estre1	VERcjg	MODE=ind|TEMPS=psp|PERS.=3|NOMB.=s
espoventez	espöenter	VERppe	NOMB.=s|GENRE=m|CAS=n
hastad	haster	VERcjg	MODE=ind|TEMPS=psp|PERS.=3|NOMB.=s
eissir	issir	VERinf	MORPH=empty
encomencement	encomencement	NOMcom	NOMB.=s|GENRE=m|CAS=r
est	estre1	VERcjg	MODE=ind|TEMPS=pst|PERS.=3|NOMB.=s
devenuz	devenir	VERppe	NOMB.=s|GENRE=m|CAS=n
homicides	omecide	NOMcom	NOMB.=s|GENRE=m|CAS=n
semblet	sembler	VERcjg	MODE=ind|TEMPS=pst|PERS.=3|NOMB.=s
fust	estre1	VERcjg	MODE=sub|TEMPS=ipf|PERS.=3|NOMB.=s
femme	feme	NOMcom	NOMB.=s|GENRE=f|CAS=r
volt	voloir	VERcjg	MODE=ind|TEMPS=psp|PERS.=3|NOMB.=s
correcier	corrocier	VERinf	MORPH=empty
crimor	cremor	NOMcom	NOMB.=s|GENRE=f|CAS=r
dewerpit	deguerpir	VERcjg	MODE=ind|TEMPS=psp|PERS.=3|NOMB.=s
fut	estre1	VERcjg	MODE=ind|TEMPS=psp|PERS.=3|NOMB.=s
obediens	obedïent	ADJqua	NOMB.=s|GENRE=m|CAS=n|DEGRE=p
voix	voiz	NOMcom	NOMB.=s|GENRE=f|CAS=r
voix	voiz	NOMcom	NOMB.=s|GENRE=f|CAS=r
bien	bien2	NOMcom	NOMB.=s|GENRE=m|CAS=n
fust	estre1	VERcjg	MODE=sub|TEMPS=ipf|PERS.=3|NOMB.=s
avenut	avenir	VERppe	NOMB.=s|GENRE=m|CAS=n
crimours	cremor	NOMcom	NOMB.=s|GENRE=f|CAS=n
äust	avoir	VERcjg	MODE=sub|TEMPS=ipf|PERS.=3|NOMB.=s
grant	grant	ADJqua	NOMB.=s|GENRE=f|CAS=r|DEGRE=p
force	force2	NOMcom	NOMB.=s|GENRE=f|CAS=r
leist	loisir1	VERcjg	MODE=ind|TEMPS=pst|PERS.=3|NOMB.=s
espiriz	esperit	NOMcom	NOMB.=s|GENRE=m|CAS=n
crimor	cremor	NOMcom	NOMB.=s|GENRE=f|CAS=r
raamplit	räemplir	VERcjg	MODE=ind|TEMPS=pst|PERS.=3|NOMB.=s
choses	chose	NOMcom	NOMB.=p|GENRE=f|CAS=r
choses	chose	NOMcom	NOMB.=p|GENRE=f|CAS=r
doit	devoir	VERcjg	MODE=ind|TEMPS=pst|PERS.=3|NOMB.=s
estre	estre1	VERinf	MORPH=empty
crimours	cremor	NOMcom	NOMB.=s|GENRE=f|CAS=n
signor	seignor	NOMcom	NOMB.=s|GENRE=m|CAS=r
mise	metre2	VERppe	NOMB.=s|GENRE=f|CAS=n
pitiet	pitié	NOMcom	NOMB.=s|GENRE=f|CAS=r
prosmes	proisme	NOMcom	NOMB.=p|GENRE=m|CAS=r
est	estre1	VERcjg	MODE=ind|TEMPS=pst|PERS.=3|NOMB.=s
soule	sol1	ADJqua	NOMB.=s|GENRE=f|CAS=n|DEGRE=p
chouse	chose	NOMcom	NOMB.=s|GENRE=f|CAS=n
omme	ome	NOMcom	NOMB.=s|GENRE=m|CAS=n
doit	devoir	VERcjg	MODE=ind|TEMPS=pst|PERS.=3|NOMB.=s
traire	traire	VERinf	MORPH=empty
freidors	froidor	NOMcom	NOMB.=s|GENRE=f|CAS=n
est	estre1	VERcjg	MODE=ind|TEMPS=pst|PERS.=3|NOMB.=s
granz	grant	ADJqua	NOMB.=s|GENRE=f|CAS=n|DEGRE=p
chauz	chaut	NOMcom	NOMB.=s|GENRE=m|CAS=n
esboillanz	esbolir	VERppa	NOMB.=s|GENRE=m|CAS=n
soi	estre1	VERcjg	MODE=ind|TEMPS=pst|PERS.=1|NOMB.=s
enpris	emprendre	VERppe	NOMB.=s|GENRE=m|CAS=n
faites	faire	VERppe	NOMB.=p|GENRE=f|CAS=r
choses	chose	NOMcom	NOMB.=p|GENRE=f|CAS=r
devis	deviser	VERcjg	MODE=ind|TEMPS=pst|PERS.=1|NOMB.=s
Haute	haut	ADJqua	NOMB.=s|GENRE=f|CAS=n|DEGRE=p
est	estre1	VERcjg	MODE=ind|TEMPS=pst|PERS.=3|NOMB.=s
matire	matiere	NOMcom	NOMB.=s|GENRE=f|CAS=n
avreit	avoir	VERcjg	MODE=con|PERS.=3|NOMB.=s
dire	dire	VERinf	MORPH=empty
list	loisir1	VERcjg	MODE=ind|TEMPS=pst|PERS.=3|NOMB.=s
demorer	demorer	VERinf	MORPH=empty
a	avoir	VERcjg	MODE=ind|TEMPS=pst|PERS.=3|NOMB.=s
parler	parler	VERinf	MORPH=empty
voudra	voloir	VERcjg	MODE=ind|TEMPS=fut|PERS.=3|NOMB.=s
saveir	savoir	VERinf	MORPH=empty
fin	fin1	NOMcom	NOMB.=s|GENRE=f|CAS=r
lise	lire1	VERcjg	MODE=sub|TEMPS=pst|PERS.=3|NOMB.=s
contrarietez	contrarïeté	NOMcom	NOMB.=p|GENRE=f|CAS=r
sunt	estre1	VERcjg	MODE=ind|TEMPS=pst|PERS.=3|NOMB.=p
granz	grant	ADJqua	NOMB.=p|GENRE=f|CAS=n|DEGRE=p
oiez	öir	VERcjg	MODE=ind|TEMPS=pst|PERS.=2|NOMB.=p
freidure	froidure	NOMcom	NOMB.=s|GENRE=f|CAS=r
arson	arson	NOMcom	NOMB.=s|GENRE=f|CAS=r
rest	restre	VERcjg	MODE=ind|TEMPS=pst|PERS.=3|NOMB.=s
doce	douz	ADJqua	NOMB.=s|GENRE=m|CAS=n|DEGRE=p
abitation	abitacion	NOMcom	NOMB.=s|GENRE=f|CAS=n
atemprement	atemprement	NOMcom	NOMB.=s|GENRE=m|CAS=r
er	air1	NOMcom	NOMB.=s|GENRE=m|CAS=r
a	avoir	VERcjg	MODE=ind|TEMPS=pst|PERS.=3|NOMB.=s
entier	entier	ADJqua	NOMB.=s|GENRE=n|CAS=n|DEGRE=p
sain	sain	ADJqua	NOMB.=s|GENRE=n|CAS=n|DEGRE=p
remés	remanoir	VERppe	NOMB.=s|GENRE=m|CAS=n
refirent	refaire2	VERcjg	MODE=ind|TEMPS=psp|PERS.=3|NOMB.=p
tens	tens	NOMcom	NOMB.=s|GENRE=m|CAS=r
esté	esté1	NOMcom	NOMB.=s|GENRE=m|CAS=r
iver	iver2	NOMcom	NOMB.=s|GENRE=m|CAS=r
part	partir	VERcjg	MODE=ind|TEMPS=pst|PERS.=3|NOMB.=s
refu	restre	VERcjg	MODE=ind|TEMPS=psp|PERS.=3|NOMB.=s
desier	desiier	NOMcom	NOMB.=s|GENRE=m|CAS=n
rentrassent	rentrer	VERcjg	MODE=sub|TEMPS=ipf|PERS.=3|NOMB.=p
navie	navie	NOMcom	NOMB.=s|GENRE=f|CAS=r
ront	ravoir2	VERcjg	MODE=ind|TEMPS=pst|PERS.=3|NOMB.=p
veie	voie	NOMcom	NOMB.=s|GENRE=f|CAS=r
acoillie	acoillir	VERppe	NOMB.=s|GENRE=f|CAS=r
finerent	finer	VERcjg	MODE=ind|TEMPS=psp|PERS.=3|NOMB.=p
retraireit	retraire	VERcjg	MODE=con|PERS.=3|NOMB.=s
dolors	dolor	NOMcom	NOMB.=s|GENRE=f|CAS=r
damage	damage	NOMcom	NOMB.=s|GENRE=m|CAS=r
firent	faire	VERcjg	MODE=ind|TEMPS=psp|PERS.=3|NOMB.=p
las	las	ADJqua	NOMB.=s|GENRE=m|CAS=n|DEGRE=p
sanc	sen2	NOMcom	NOMB.=s|GENRE=m|CAS=r
espandirent	espandre	VERcjg	MODE=ind|TEMPS=psp|PERS.=3|NOMB.=p
arstrent	ardre	VERcjg	MODE=ind|TEMPS=psp|PERS.=3|NOMB.=p
trebucherent	trebuchier	VERcjg	MODE=ind|TEMPS=psp|PERS.=3|NOMB.=p
terre	terre	NOMcom	NOMB.=s|GENRE=f|CAS=r
essillerent	essillier	VERcjg	MODE=ind|TEMPS=psp|PERS.=3|NOMB.=p
cuvers	culvert	NOMcom	NOMB.=p|GENRE=m|CAS=n
chiens	chien	NOMcom	NOMB.=p|GENRE=m|CAS=n
refirent	refaire2	VERcjg	MODE=ind|TEMPS=psp|PERS.=3|NOMB.=p
avint	avenir	VERcjg	MODE=ind|TEMPS=psp|PERS.=3|NOMB.=s
feiee	foie2	NOMcom	NOMB.=s|GENRE=f|CAS=r
vis	vil1	ADJqua	NOMB.=p|GENRE=m|CAS=r|DEGRE=p
jenz	gent1	NOMcom	NOMB.=p|GENRE=m|CAS=r
reneiee	renoiier1	VERppe	NOMB.=s|GENRE=f|CAS=r
fussant	estre1	VERcjg	MODE=sub|TEMPS=ipf|PERS.=3|NOMB.=p
destruit	destruire	VERppe	NOMB.=p|GENRE=m|CAS=n
mort	morir	VERppe	NOMB.=p|GENRE=m|CAS=n
vencu	veintre	VERppe	NOMB.=p|GENRE=m|CAS=n
tens	tens	NOMcom	NOMB.=p|GENRE=m|CAS=r
est	estre1	VERcjg	MODE=ind|TEMPS=pst|PERS.=3|NOMB.=s
avenu	avenir	VERppe	NOMB.=s|GENRE=m|CAS=n
a	avoir	VERcjg	MODE=ind|TEMPS=pst|PERS.=3|NOMB.=s
mau	mal1	NOMcom	NOMB.=s|GENRE=m|CAS=r
traïtor	träitor	NOMcom	NOMB.=s|GENRE=m|CAS=n
desleié	desliier	VERppe	NOMB.=s|GENRE=m|CAS=n
felon	felon	ADJqua	NOMB.=s|GENRE=m|CAS=n|DEGRE=p
parjur	parjur	ADJqua	NOMB.=s|GENRE=m|CAS=n|DEGRE=p
orrible	orrible	ADJqua	NOMB.=s|GENRE=m|CAS=n|DEGRE=p
feimentie	foimentie	NOMcom	NOMB.=s|GENRE=m|CAS=n
hontos	hontos	ADJqua	NOMB.=s|GENRE=m|CAS=n|DEGRE=p
vis	vil1	ADJqua	NOMB.=s|GENRE=m|CAS=n|DEGRE=p
pleins	plein	ADJqua	NOMB.=s|GENRE=m|CAS=n|DEGRE=p
felonnie	felonie	NOMcom	NOMB.=s|GENRE=f|CAS=r
seient	estre1	VERcjg	MODE=sub|TEMPS=pst|PERS.=3|NOMB.=p
mostrez	mostrer	VERppe	NOMB.=p|GENRE=m|CAS=n
deiz	doi	NOMcom	NOMB.=p|GENRE=m|CAS=r
desleiaus	deslëal	ADJqua	NOMB.=p|GENRE=m|CAS=n|DEGRE=p
faus	faus	ADJqua	NOMB.=p|GENRE=m|CAS=n|DEGRE=p
reneiz	renoiier1	VERppe	NOMB.=p|GENRE=m|CAS=n
funt	faire	VERcjg	MODE=ind|TEMPS=pst|PERS.=3|NOMB.=p
deserte	deserte2	NOMcom	NOMB.=s|GENRE=f|CAS=r
dreiz	droit	ADJqua	NOMB.=s|GENRE=m|CAS=n|DEGRE=p
est	estre1	VERcjg	MODE=ind|TEMPS=pst|PERS.=3|NOMB.=s
cous	col	NOMcom	NOMB.=p|GENRE=m|CAS=r
reverte	revertir	VERcjg	MODE=sub|TEMPS=pst|PERS.=3|NOMB.=s
orrible	orrible	ADJqua	NOMB.=s|GENRE=f|CAS=r|DEGRE=p
jent	gent1	NOMcom	NOMB.=s|GENRE=f|CAS=r
fust	estre1	VERcjg	MODE=sub|TEMPS=ipf|PERS.=3|NOMB.=s
firmament	firmament	NOMcom	NOMB.=s|GENRE=m|CAS=r
consenti	consentir	VERcjg	MODE=ind|TEMPS=psp|PERS.=3|NOMB.=s
mesfait	mesfait	NOMcom	NOMB.=s|GENRE=m|CAS=n
